Rk	Player	Pos	Age	Tm	G	GS	MP	FG	FGA	FG%	3P	3PA	3P%	2P	2PA	2P%	eFG%	FT	FTA	FT%	ORB	DRB	TRB	AST	STL	BLK	TOV	PF	PTS
1	Álex Abrines	SG	24	OKC	75	8	1134	115	291	0395	84	221	0380	31	70	0443	0540	39	46	0848	26	88	114	28	38	8	25	124	353
2	Quincy Acy	PF	27	BRK	70	8	1359	130	365	0356	102	292	0349	28	73	0384	0496	49	60	0817	40	217	257	57	33	29	60	149	411
3	Steven Adams	C	24	OKC	76	76	2487	448	712	0629	0	2	0000	448	710	0631	0629	160	286	0559	384	301	685	88	92	78	128	215	1056
4	Bam Adebayo	C	20	MIA	69	19	1368	174	340	0512	0	7	0000	174	333	0523	0512	129	179	0721	118	263	381	101	32	41	66	138	477
5	Arron Afflalo	SG	32	ORL	53	3	682	65	162	0401	27	70	0386	38	92	0413	0485	22	26	0846	4	62	66	30	4	9	21	56	179
6	Cole Aldrich	C	29	MIN	21	0	49	5	15	0333	0	0	0	5	15	0333	0333	2	6	0333	3	12	15	3	2	1	1	11	12
7	LaMarcus Aldridge	C	32	SAS	75	75	2509	687	1347	0510	27	92	0293	660	1255	0526	0520	334	399	0837	246	389	635	152	43	90	111	161	1735
8	Jarrett Allen	C	19	BRK	72	31	1441	234	397	0589	5	15	0333	229	382	0599	0596	114	147	0776	144	244	388	49	28	88	82	147	587
9	Kadeem Allen	PG	25	BOS	18	1	107	6	22	0273	0	11	0000	6	11	0545	0273	7	9	0778	4	7	11	12	3	2	9	15	19
10	Tony Allen	SF	36	NOP	22	0	273	44	91	0484	4	12	0333	40	79	0506	0505	11	21	0524	20	27	47	9	11	3	19	49	103
11	Al-Farouq Aminu	PF	27	POR	69	67	2072	230	582	0395	125	339	0369	105	243	0432	0503	59	80	0738	97	428	525	84	79	40	79	136	644
12	Justin Anderson	SF	24	PHI	38	0	519	87	202	0431	34	103	0330	53	99	0535	0515	28	38	0737	25	68	93	25	15	7	16	54	236
13	Kyle Anderson	SF	24	SAS	74	67	1978	231	438	0527	19	57	0333	212	381	0556	0549	104	146	0712	84	312	396	202	115	60	94	114	585
14	Ryan Anderson	PF	29	HOU	66	50	1725	207	480	0431	131	339	0386	76	141	0539	0568	72	93	0774	94	237	331	60	24	21	42	126	617
15	Ike Anigbogu	C	19	IND	11	0	30	4	9	0444	0	0	0	4	9	0444	0444	5	6	0833	5	4	9	0	1	3	2	1	13
16	Giannis Antetokounmpo	PF	23	MIL	75	75	2756	742	1402	0529	43	140	0307	699	1262	0554	0545	487	641	0760	156	597	753	361	109	106	223	231	2014
17	Carmelo Anthony	PF	33	OKC	78	78	2501	472	1168	0404	169	474	0357	303	694	0437	0476	148	193	0767	67	386	453	103	47	49	99	197	1261
18	OG Anunoby	SF	20	TOR	74	62	1481	163	346	0471	73	197	0371	90	149	0604	0577	39	62	0629	44	140	184	55	52	14	45	130	438
19	Ryan Arcidiacono	PG	23	CHI	24	0	304	17	41	0415	9	31	0290	8	10	0800	0524	5	6	0833	1	24	25	35	13	0	13	18	48
20	Trevor Ariza	SF	32	HOU	67	67	2269	268	651	0412	170	462	0368	98	189	0519	0542	76	89	0854	33	261	294	105	98	13	52	132	782
21	Darrell Arthur	PF	29	DEN	19	1	141	22	47	0468	8	23	0348	14	24	0583	0553	2	3	0667	3	12	15	9	8	3	15	22	54
22	Jamel Artis	SG	25	ORL	15	1	279	31	79	0392	8	29	0276	23	50	0460	0443	7	12	0583	4	34	38	18	2	3	8	11	77
23	Ömer Aşık	C	31	TOT	18	0	182	9	22	0409	0	0	0	9	22	0409	0409	4	13	0308	9	38	47	3	2	4	9	20	22
23	Ömer Aşık	C	31	NOP	14	0	121	7	16	0438	0	0	0	7	16	0438	0438	4	12	0333	7	30	37	2	1	2	5	14	18
23	Ömer Aşık	C	31	CHI	4	0	61	2	6	0333	0	0	0	2	6	0333	0333	0	1	0000	2	8	10	1	1	2	4	6	4
24	D0J0 Augustin	PG	30	ORL	75	36	1760	244	540	0452	114	272	0419	130	268	0485	0557	164	189	0868	30	130	160	287	54	0	123	94	766
25	Luke Babbitt	SF	28	TOT	50	14	715	91	215	0423	60	156	0385	31	59	0525	0563	17	22	0773	7	89	96	31	8	7	19	54	259
25	Luke Babbitt	SF	28	ATL	37	9	570	80	168	0476	49	111	0441	31	57	0544	0622	17	22	0773	5	76	81	26	7	5	15	47	226
25	Luke Babbitt	SF	28	MIA	13	5	145	11	47	0234	11	45	0244	0	2	0000	0351	0	0	0	2	13	15	5	1	2	4	7	33
26	Dwayne Bacon	SG	22	CHO	53	6	713	72	192	0375	11	43	0256	61	149	0409	0404	20	25	0800	4	120	124	38	16	2	23	46	175
27	Ron Baker	SG	24	NYK	29	1	385	20	59	0339	11	33	0333	9	26	0346	0432	20	26	0769	5	25	30	47	26	6	18	33	71
28	Wade Baldwin	PG	21	POR	7	0	80	14	21	0667	4	5	0800	10	16	0625	0762	6	10	0600	1	7	8	5	2	1	4	12	38
29	Lonzo Ball	PG	20	LAL	52	50	1780	203	564	0360	90	295	0305	113	269	0420	0440	32	71	0451	69	291	360	376	88	43	136	117	528
30	J0J0 Barea	PG	33	DAL	69	10	1603	303	690	0439	115	313	0367	188	377	0499	0522	80	102	0784	15	186	201	434	35	3	143	83	801
31	Harrison Barnes	PF	25	DAL	77	77	2634	537	1208	0445	119	333	0357	418	875	0478	0494	259	313	0827	77	391	468	152	49	14	118	94	1452
32	Will Barton	SG	27	DEN	81	40	2683	465	1028	0452	156	422	0370	309	606	0510	0528	182	226	0805	70	339	409	331	82	52	149	168	1268
33	Nicolas Batum	SG	29	CHO	64	64	1981	270	650	0415	92	274	0336	178	376	0473	0486	108	130	0831	57	249	306	349	65	23	131	72	740
34	Jerryd Bayless	SG	29	PHI	39	11	925	109	262	0416	54	146	0370	55	116	0474	0519	35	44	0795	15	65	80	54	23	6	46	91	307
35	Aron Baynes	C	31	BOS	81	67	1485	210	446	0471	3	21	0143	207	425	0487	0474	59	78	0756	130	304	434	93	22	51	80	200	482
36	Kent Bazemore	SG	28	ATL	65	65	1789	284	676	0420	108	274	0394	176	402	0438	0500	160	201	0796	25	223	248	228	100	45	157	147	836
37	Bradley Beal	SG	24	WAS	82	82	2977	683	1484	0460	199	530	0375	484	954	0507	0527	292	369	0791	61	302	363	373	96	36	214	160	1857
38	Malik Beasley	SG	21	DEN	62	0	583	73	178	0410	28	82	0341	45	96	0469	0489	22	33	0667	14	57	71	31	15	7	24	36	196
39	Michael Beasley	PF	29	NYK	74	30	1653	409	807	0507	34	86	0395	375	721	0520	0528	124	159	0780	97	317	414	123	36	43	143	145	976
40	Marco Belinelli	SG	31	TOT	80	2	1947	337	764	0441	149	395	0377	188	369	0509	0539	148	163	0908	20	131	151	148	66	12	94	91	971
40	Marco Belinelli	SG	31	ATL	52	1	1210	199	485	0410	92	247	0372	107	238	0450	0505	101	109	0927	14	86	100	103	46	3	54	41	591
40	Marco Belinelli	SG	31	PHI	28	1	737	138	279	0495	57	148	0385	81	131	0618	0597	47	54	0870	6	45	51	45	20	9	40	50	380
41	Jordan Bell	C	23	GSW	57	13	809	116	185	0627	0	4	0000	116	181	0641	0627	30	44	0682	60	147	207	102	35	56	51	92	262
42	DeAndre' Bembry	SF	23	ATL	26	3	455	53	128	0414	11	30	0367	42	98	0429	0457	19	33	0576	8	64	72	49	21	12	47	38	136
43	Dragan Bender	PF	20	PHO	82	37	2069	187	484	0386	118	322	0366	69	162	0426	0508	39	51	0765	40	321	361	130	22	53	112	166	531
44	Dāvis Bertāns	PF	25	SAS	77	10	1086	161	366	0440	94	252	0373	67	114	0588	0568	40	49	0816	18	135	153	74	26	28	36	93	456
45	Patrick Beverley	SG	29	LAC	11	11	334	48	119	0403	24	60	0400	24	59	0407	0504	14	17	0824	16	29	45	32	19	5	25	34	134
46	Khem Birch	C	25	ORL	42	0	578	68	126	0540	0	0	0	68	126	0540	0540	42	61	0689	70	110	180	34	15	21	21	56	178
47	Jabari Bird	SG	23	BOS	13	1	115	15	26	0577	3	7	0429	12	19	0632	0635	6	13	0462	6	13	19	8	3	1	8	7	39
48	Bismack Biyombo	C	25	ORL	82	25	1495	183	352	0520	0	1	0000	183	351	0521	0520	102	157	0650	144	324	468	66	21	95	84	158	468
49	Nemanja Bjelica	PF	29	MIN	67	21	1371	171	371	0461	76	183	0415	95	188	0505	0563	36	45	0800	53	221	274	86	50	16	52	141	454
50	Tarik Black	C	26	HOU	51	2	536	75	127	0591	1	11	0091	74	116	0638	0594	29	63	0460	63	100	163	13	21	30	35	107	180
51	Antonio Blakeney	SG	21	CHI	19	0	314	53	143	0371	15	52	0288	38	91	0418	0423	30	39	0769	4	29	33	20	7	1	11	19	151
52	Eric Bledsoe	PG	28	TOT	74	74	2322	468	989	0473	125	360	0347	343	629	0545	0536	252	317	0795	51	233	284	370	149	42	216	185	1313
52	Eric Bledsoe	PG	28	PHO	3	3	83	16	40	0400	4	13	0308	12	27	0444	0450	11	14	0786	3	4	7	9	4	2	10	6	47
52	Eric Bledsoe	PG	28	MIL	71	71	2239	452	949	0476	121	347	0349	331	602	0550	0540	241	303	0795	48	229	277	361	145	40	206	179	1266
53	Vander Blue	SG	25	LAL	5	0	45	1	5	0200	0	2	0000	1	3	0333	0200	1	2	0500	0	1	1	3	1	0	3	2	3
54	Bogdan Bogdanović	SG	25	SAC	78	53	2175	344	772	0446	129	329	0392	215	443	0485	0529	100	119	0840	31	192	223	258	72	16	125	172	917
55	Bojan Bogdanović	SF	28	IND	80	80	2464	404	852	0474	155	386	0402	249	466	0534	0565	178	205	0868	30	240	270	119	55	8	106	129	1141
56	Andrew Bogut	C	33	LAL	24	5	216	17	25	0680	0	0	0	17	25	0680	0680	2	2	10000	26	52	78	15	4	13	19	40	36
57	Joel Bolomboy	PF	24	MIL	6	0	38	3	6	0500	0	1	0000	3	5	0600	0500	3	6	0500	6	4	10	0	2	0	2	3	9
58	Devin Booker	SG	21	PHO	54	54	1865	455	1054	0432	147	384	0383	308	670	0460	0501	289	329	0878	26	218	244	253	47	14	194	168	1346
59	Trevor Booker	PF	30	TOT	68	7	1158	177	343	0516	8	33	0242	169	310	0545	0528	66	93	0710	117	201	318	82	28	21	59	119	428
59	Trevor Booker	PF	30	BRK	18	6	395	77	150	0513	3	12	0250	74	138	0536	0523	24	43	0558	38	81	119	38	8	5	30	43	181
59	Trevor Booker	PF	30	PHI	33	0	494	61	109	0560	2	7	0286	59	102	0578	0569	32	39	0821	47	75	122	27	16	11	20	50	156
59	Trevor Booker	PF	30	IND	17	1	269	39	84	0464	3	14	0214	36	70	0514	0482	10	11	0909	32	45	77	17	4	5	9	26	91
60	Chris Boucher	PF	25	GSW	1	0	1	0	1	0000	0	1	0000	0	0	0	0000	0	0	0	0	1	1	0	0	0	0	0	0
61	Avery Bradley	SG	27	TOT	46	46	1433	259	625	0414	75	203	0369	184	422	0436	0474	63	82	0768	22	94	116	94	51	8	101	92	656
61	Avery Bradley	SG	27	DET	40	40	1268	233	570	0409	74	194	0381	159	376	0423	0474	61	80	0763	19	75	94	83	46	7	93	80	601
61	Avery Bradley	SG	27	LAC	6	6	165	26	55	0473	1	9	0111	25	46	0543	0482	2	2	10000	3	19	22	11	5	1	8	12	55
62	Tony Bradley	C	20	UTA	9	0	29	3	11	0273	0	1	0000	3	10	0300	0273	2	2	10000	4	7	11	1	0	0	0	1	8
63	Corey Brewer	SF-SG	31	TOT	72	18	1208	142	316	0449	31	110	0282	111	206	0539	0498	65	90	0722	43	111	154	65	79	14	49	139	380
63	Corey Brewer	SF	31	LAL	54	2	694	78	172	0453	8	43	0186	70	129	0543	0477	34	51	0667	23	70	93	41	41	8	38	83	198
63	Corey Brewer	SG	31	OKC	18	16	514	64	144	0444	23	67	0343	41	77	0532	0524	31	39	0795	20	41	61	24	38	6	11	56	182
64	Malcolm Brogdon	PG	25	MIL	48	20	1436	244	503	0485	62	161	0385	182	342	0532	0547	75	85	0882	23	133	156	152	41	13	66	128	625
65	Aaron Brooks	PG	33	MIN	32	1	189	28	69	0406	11	31	0355	17	38	0447	0486	8	11	0727	7	10	17	20	6	0	11	28	75
66	Dillon Brooks	SF	22	MEM	82	74	2350	340	772	0440	94	264	0356	246	508	0484	0501	124	166	0747	49	208	257	135	73	17	124	233	898
67	MarShon Brooks	SG	29	MEM	7	1	193	51	102	0500	19	32	0594	32	70	0457	0593	20	23	0870	8	13	21	25	11	3	16	6	141
68	Anthony Brown	SF	25	MIN	1	0	4	1	1	10000	1	1	10000	0	0	0	10500	0	0	0	0	0	0	1	0	0	0	0	3
69	Bobby Brown	PG	33	HOU	20	0	115	19	58	0328	11	40	0275	8	18	0444	0422	1	2	0500	0	7	7	11	4	0	9	6	50
70	Jaylen Brown	SG	21	BOS	70	70	2152	373	803	0465	121	306	0395	252	497	0507	0540	150	233	0644	66	280	346	114	70	26	124	181	1017
71	Lorenzo Brown	PG	27	TOR	14	0	139	14	34	0412	2	12	0167	12	22	0545	0441	2	2	10000	1	14	15	13	5	0	3	7	32
72	Markel Brown	SG	26	HOU	4	0	31	2	7	0286	1	5	0200	1	2	0500	0357	0	0	0	1	4	5	2	0	0	2	6	5
73	Sterling Brown	SG	22	MIL	54	4	776	82	205	0400	32	91	0352	50	114	0439	0478	21	24	0875	27	116	143	25	31	13	25	80	217
74	Nicolás Brussino	SF	24	ATL	4	0	10	0	2	0000	0	2	0000	0	0	0	0000	0	0	0	0	3	3	0	0	0	0	0	0
75	Thomas Bryant	C	20	LAL	15	0	72	8	21	0381	1	10	0100	7	11	0636	0405	5	9	0556	3	14	17	6	1	2	2	6	22
76	Reggie Bullock	SF	26	DET	62	52	1732	267	546	0489	125	281	0445	142	265	0536	0603	39	49	0796	27	127	154	95	47	13	47	70	698
77	Trey Burke	PG	25	NYK	36	9	785	193	384	0503	38	105	0362	155	279	0556	0552	37	57	0649	13	58	71	170	24	4	43	43	461
78	Alec Burks	SG	26	UTA	64	1	1059	170	414	0411	47	142	0331	123	272	0452	0467	107	124	0863	19	173	192	67	37	8	60	75	494
79	Jimmy Butler	SG	28	MIN	59	59	2164	437	921	0474	70	200	0350	367	721	0509	0512	363	425	0854	79	235	314	288	116	24	108	78	1307
80	Dwight Buycks	PG	28	DET	29	0	427	82	198	0414	15	45	0333	67	153	0438	0452	36	41	0878	12	29	41	59	19	2	39	39	215
81	Bruno Caboclo	SF	22	TOT	12	0	107	9	31	0290	3	17	0176	6	14	0429	0339	5	6	0833	7	15	22	4	3	4	4	8	26
81	Bruno Caboclo	SF	22	TOR	2	0	7	0	2	0000	0	2	0000	0	0	0	0000	0	0	0	0	1	1	1	1	0	0	1	0
81	Bruno Caboclo	SF	22	SAC	10	0	100	9	29	0310	3	15	0200	6	14	0429	0362	5	6	0833	7	14	21	3	2	4	4	7	26
82	José Calderón	PG	36	CLE	57	32	914	93	185	0503	45	97	0464	48	88	0545	0624	24	30	0800	14	70	84	117	27	2	41	81	255
83	Kentavious Caldwell-Pope	SG	24	LAL	74	74	2458	340	798	0426	159	415	0383	181	383	0473	0526	153	194	0789	60	327	387	162	106	16	97	145	992
84	Isaiah Canaan	PG-SG	26	TOT	20	1	422	52	137	0380	22	66	0333	30	71	0423	0460	46	51	0902	6	39	45	76	16	1	29	36	172
84	Isaiah Canaan	SG	26	HOU	1	0	4	0	1	0000	0	0	0	0	1	0000	0000	0	0	0	0	1	1	0	0	0	0	0	0
84	Isaiah Canaan	PG	26	PHO	19	1	418	52	136	0382	22	66	0333	30	70	0429	0463	46	51	0902	6	38	44	76	16	1	29	36	172
85	Clint Capela	C	23	HOU	74	74	2034	441	676	0652	0	1	0000	441	675	0653	0652	144	257	0560	241	561	802	68	58	137	103	185	1026
86	DeMarre Carroll	PF	31	BRK	73	73	2180	325	785	0414	145	391	0371	180	394	0457	0506	188	246	0764	105	374	479	147	59	30	103	165	983
87	Vince Carter	SF	41	SAC	58	5	1026	114	283	0403	57	165	0345	57	118	0483	0504	28	37	0757	18	130	148	69	42	26	36	96	313
88	Michael Carter-Williams	PG	26	CHO	52	2	835	76	229	0332	14	59	0237	62	170	0365	0362	73	89	0820	37	101	138	116	44	23	52	99	239
89	Alex Caruso	PG	23	LAL	37	7	562	50	116	0431	13	43	0302	37	73	0507	0487	21	30	0700	15	50	65	75	23	10	42	52	134
90	Omri Casspi	SF	29	GSW	53	7	740	120	207	0580	10	22	0455	110	185	0595	0604	50	69	0725	30	170	200	51	18	19	37	71	300
91	Willie Cauley-Stein	C	24	SAC	73	58	2044	388	773	0502	3	12	0250	385	761	0506	0504	153	247	0619	131	379	510	172	77	67	109	185	932
92	Tyler Cavanaugh	PF	23	ATL	39	1	518	67	152	0441	32	89	0360	35	63	0556	0546	17	21	0810	45	82	127	27	9	4	14	61	183
93	Mario Chalmers	PG	31	MEM	66	10	1421	168	443	0379	53	191	0277	115	252	0456	0439	118	138	0855	13	144	157	197	79	14	117	179	507
94	Tyson Chandler	C	35	PHO	46	46	1151	121	187	0647	0	0	0	121	187	0647	0647	58	93	0624	134	284	418	53	16	27	59	106	300
95	Wilson Chandler	SF	30	DEN	74	71	2346	281	631	0445	88	246	0358	193	385	0501	0515	88	114	0772	102	296	398	159	43	39	92	156	738
96	Marquese Chriss	PF	20	PHO	72	49	1527	202	477	0423	56	190	0295	146	287	0509	0482	96	158	0608	76	319	395	83	51	70	107	205	556
97	Ian Clark	SG	26	NOP	74	2	1455	222	495	0448	62	195	0318	160	300	0533	0511	45	59	0763	10	117	127	110	33	10	57	120	551
98	Jordan Clarkson	SG	25	TOT	81	2	1888	430	954	0451	112	318	0352	318	636	0500	0509	152	190	0800	57	160	217	221	58	6	127	107	1124
98	Jordan Clarkson	SG	25	LAL	53	2	1256	299	667	0448	68	210	0324	231	457	0505	0499	105	132	0795	44	115	159	173	39	3	95	63	771
98	Jordan Clarkson	SG	25	CLE	28	0	632	131	287	0456	44	108	0407	87	179	0486	0533	47	58	0810	13	45	58	48	19	3	32	44	353
99	Gian Clavell	SG	24	DAL	7	0	64	6	18	0333	6	15	0400	0	3	0000	0500	2	2	10000	1	6	7	3	2	0	2	8	20
100	Antonius Cleveland	SG	23	TOT	17	0	123	8	21	0381	3	4	0750	5	17	0294	0452	4	6	0667	3	11	14	2	7	5	7	23	23
100	Antonius Cleveland	SG	23	DAL	13	0	81	4	14	0286	0	1	0000	4	13	0308	0286	2	4	0500	2	8	10	2	6	4	2	11	10
100	Antonius Cleveland	SG	23	ATL	4	0	42	4	7	0571	3	3	10000	1	4	0250	0786	2	2	10000	1	3	4	0	1	1	5	12	13
101	John Collins	PF	20	ATL	74	26	1785	314	545	0576	16	47	0340	298	498	0598	0591	133	186	0715	176	365	541	98	47	80	105	215	777
102	Zach Collins	C	20	POR	66	1	1045	115	289	0398	35	113	0310	80	176	0455	0458	27	42	0643	45	176	221	52	17	31	58	133	292
103	Kyle Collinsworth	SF	26	DAL	32	2	480	38	99	0384	4	17	0235	34	82	0415	0404	21	40	0525	32	75	107	56	17	9	24	44	101
104	Darren Collison	PG	30	IND	69	64	2018	316	638	0495	96	205	0468	220	433	0508	0571	127	144	0882	37	141	178	368	92	15	86	122	855
105	Nick Collison	PF	37	OKC	15	0	75	13	19	0684	0	0	0	13	19	0684	0684	5	13	0385	7	13	20	4	0	0	7	7	31
106	Mike Conley	PG	30	MEM	12	12	373	64	168	0381	24	77	0312	40	91	0440	0452	53	66	0803	0	27	27	49	12	3	18	24	205
107	Pat Connaughton	SG	25	POR	82	5	1488	165	390	0423	74	210	0352	91	180	0506	0518	37	44	0841	36	125	161	91	23	22	43	120	441
108	Quinn Cook	PG	24	GSW	33	18	740	122	252	0484	46	104	0442	76	148	0514	0575	22	25	0880	10	72	82	89	12	1	32	59	312
109	Charles Cooke	SG	23	NOP	13	0	38	2	14	0143	1	8	0125	1	6	0167	0179	1	2	0500	0	2	2	1	1	0	1	0	6
110	Jack Cooley	PF	26	SAC	7	0	87	13	27	0481	0	0	0	13	27	0481	0481	14	19	0737	14	16	30	6	1	0	3	13	40
111	Matt Costello	C	24	SAS	4	0	32	2	4	0500	0	0	0	2	4	0500	0500	0	0	0	1	8	9	2	2	2	1	7	4
112	DeMarcus Cousins	C	27	NOP	48	48	1737	406	864	0470	104	294	0354	302	570	0530	0530	294	394	0746	105	512	617	257	79	76	242	183	1210
113	Robert Covington	SF	27	PHI	80	80	2532	345	836	0413	203	550	0369	142	286	0497	0534	116	136	0853	55	378	433	156	137	72	126	238	1009
114	Allen Crabbe	SG	25	BRK	75	68	2197	337	827	0407	201	532	0378	136	295	0461	0529	115	135	0852	28	296	324	117	47	35	78	168	990
115	Torrey Craig	SF	27	DEN	39	5	629	62	137	0453	17	58	0293	45	79	0570	0515	22	35	0629	40	87	127	25	12	15	20	63	163
116	Jamal Crawford	SG	37	MIN	80	0	1653	308	742	0415	104	314	0331	204	428	0477	0485	102	113	0903	21	78	99	185	40	9	95	85	822
117	Jordan Crawford	SG	29	NOP	5	0	53	12	27	0444	8	14	0571	4	13	0308	0593	1	1	10000	2	2	4	13	1	1	5	7	33
118	Jae Crowder	SF	27	TOT	80	47	2090	271	671	0404	110	341	0323	161	330	0488	0486	121	148	0818	59	216	275	99	64	21	74	187	773
118	Jae Crowder	SF	27	CLE	53	47	1346	157	376	0418	62	189	0328	95	187	0508	0500	78	92	0848	41	132	173	58	41	12	42	124	454
118	Jae Crowder	SF	27	UTA	27	0	744	114	295	0386	48	152	0316	66	143	0462	0468	43	56	0768	18	84	102	41	23	9	32	63	319
119	Dante Cunningham	SF	30	TOT	73	25	1562	164	364	0451	58	168	0345	106	196	0541	0530	31	52	0596	78	220	298	48	39	30	33	111	417
119	Dante Cunningham	SF	30	NOP	51	24	1115	99	225	0440	35	108	0324	64	117	0547	0518	20	36	0556	50	143	193	26	27	16	16	75	253
119	Dante Cunningham	SF	30	BRK	22	1	447	65	139	0468	23	60	0383	42	79	0532	0550	11	16	0688	28	77	105	22	12	14	17	36	164
120	Stephen Curry	PG	29	GSW	51	51	1631	428	864	0495	212	501	0423	216	363	0595	0618	278	302	0921	36	225	261	310	80	8	153	114	1346
121	Troy Daniels	SG	26	PHO	79	15	1622	232	575	0403	183	458	0400	49	117	0419	0563	56	64	0875	12	115	127	48	26	5	56	137	703
122	Anthony Davis	PF	24	NOP	75	75	2727	780	1462	0534	55	162	0340	725	1300	0558	0552	495	598	0828	187	645	832	174	115	193	162	159	2110
123	Deyonta Davis	C	21	MEM	62	6	943	161	265	0608	0	0	0	161	265	0608	0608	38	57	0667	75	175	250	40	15	39	32	125	360
124	Ed Davis	C	28	POR	78	0	1471	170	292	0582	0	1	0000	170	291	0584	0582	74	111	0667	183	392	575	40	32	52	66	188	414
125	Dewayne Dedmon	C	28	ATL	62	46	1542	250	477	0524	50	141	0355	200	336	0595	0577	67	86	0779	100	389	489	90	40	51	86	162	617
126	Sam Dekker	PF	23	LAC	73	1	883	128	259	0494	10	60	0167	118	199	0593	0514	37	56	0661	44	130	174	38	24	9	33	71	303
127	Malcolm Delaney	PG	28	ATL	54	3	1014	109	285	0382	46	124	0371	63	161	0391	0463	74	92	0804	9	91	100	163	35	6	66	82	338
128	Matthew Dellavedova	PG	27	MIL	38	3	712	55	152	0362	29	78	0372	26	74	0351	0457	25	27	0926	14	50	64	145	14	0	49	67	164
129	Luol Deng	SF	32	LAL	1	1	13	1	2	0500	0	0	0	1	2	0500	0500	0	0	0	0	0	0	1	1	0	1	0	2
130	DeMar DeRozan	SG	28	TOR	80	80	2711	645	1413	0456	89	287	0310	556	1126	0494	0488	461	559	0825	59	256	315	417	85	22	175	151	1840
131	Cheick Diallo	PF	21	NOP	52	0	581	102	176	0580	0	0	0	102	176	0580	0580	50	66	0758	47	164	211	19	11	21	28	82	254
132	Gorgui Dieng	C	28	MIN	79	0	1333	186	388	0479	19	61	0311	167	327	0511	0504	79	102	0775	106	254	360	71	45	39	59	147	470
133	Spencer Dinwiddie	PG	24	BRK	80	58	2306	324	838	0387	141	433	0326	183	405	0452	0471	218	268	0813	40	219	259	524	68	23	128	186	1007
134	Tyler Dorsey	SG	21	ATL	56	5	974	144	382	0377	72	199	0362	72	183	0393	0471	45	63	0714	17	113	130	79	17	5	37	63	405
135	Damyean Dotson	SG	23	NYK	44	2	474	72	161	0447	22	68	0324	50	93	0538	0516	16	23	0696	9	75	84	31	12	2	17	34	182
136	Milton Doyle	SG	24	BRK	10	0	125	13	47	0277	4	23	0174	9	24	0375	0319	4	8	0500	3	15	18	10	6	2	2	13	34
137	PJ Dozier	PG	21	OKC	2	0	3	1	2	0500	0	0	0	1	2	0500	0500	0	0	0	0	1	1	0	0	0	1	1	2
138	Goran Dragić	PG	31	MIA	75	75	2378	484	1075	0450	111	300	0370	373	775	0481	0502	217	271	0801	54	252	306	359	63	12	166	180	1296
139	Larry Drew II	PG	27	TOT	10	0	70	7	24	0292	3	9	0333	4	15	0267	0354	0	0	0	3	0	3	10	0	0	3	6	17
139	Larry Drew II	PG	27	PHI	3	0	15	1	7	0143	0	3	0000	1	4	0250	0143	0	0	0	1	0	1	2	0	0	1	2	2
139	Larry Drew II	PG	27	NOP	7	0	55	6	17	0353	3	6	0500	3	11	0273	0441	0	0	0	2	0	2	8	0	0	2	4	15
140	Andre Drummond	C	24	DET	78	78	2625	466	881	0529	0	11	0000	466	870	0536	0529	239	395	0605	399	848	1247	237	114	127	200	250	1171
141	Jared Dudley	PF	32	PHO	48	0	686	48	122	0393	29	80	0363	19	42	0452	0512	27	35	0771	8	86	94	78	24	11	28	85	152
142	Kris Dunn	PG	23	CHI	52	43	1525	286	666	0429	43	134	0321	243	532	0457	0462	84	114	0737	24	197	221	310	104	27	150	174	699
143	Kevin Durant	SF	29	GSW	68	68	2325	630	1222	0516	173	413	0419	457	809	0565	0586	359	404	0889	31	433	464	366	50	119	207	133	1792
144	Jarell Eddie	SF	26	TOT	3	0	9	0	2	0000	0	2	0000	0	0	0	0000	0	0	0	0	1	1	0	1	0	0	0	0
144	Jarell Eddie	SF	26	BOS	2	0	6	0	1	0000	0	1	0000	0	0	0	0000	0	0	0	0	1	1	0	1	0	0	0	0
144	Jarell Eddie	SF	26	CHI	1	0	3	0	1	0000	0	1	0000	0	0	0	0000	0	0	0	0	0	0	0	0	0	0	0	0
145	Henry Ellenson	PF	21	DET	38	0	329	53	146	0363	20	60	0333	33	86	0384	0432	25	29	0862	10	71	81	20	5	0	18	22	151
146	Wayne Ellington	SG	30	MIA	77	2	2041	285	700	0407	227	579	0392	58	121	0479	0569	67	78	0859	23	195	218	79	53	8	52	94	864
147	Joel Embiid	C	23	PHI	63	63	1912	510	1056	0483	66	214	0308	444	842	0527	0514	359	467	0769	143	547	690	199	40	111	234	209	1445
148	James Ennis III	SF	27	TOT	72	22	1604	182	384	0474	51	153	0333	131	231	0567	0540	97	116	0836	73	151	224	71	47	18	56	134	512
148	James Ennis III	SF	27	MEM	45	14	1053	108	222	0486	30	84	0357	78	138	0565	0554	64	73	0877	53	104	157	49	32	12	38	81	310
148	James Ennis III	SF	27	DET	27	8	551	74	162	0457	21	69	0304	53	93	0570	0522	33	43	0767	20	47	67	22	15	6	18	53	202
149	Tyler Ennis	PG	23	LAL	54	11	683	94	224	0420	14	56	0250	80	168	0476	0451	22	29	0759	19	76	95	105	30	10	38	75	224
150	Jawun Evans	PG	21	LAC	48	4	778	89	253	0352	15	54	0278	74	199	0372	0381	38	49	0776	9	75	84	100	36	6	44	97	231
151	Jeremy Evans	SF	30	ATL	1	0	5	1	1	10000	0	0	0	1	1	10000	10000	0	0	0	1	0	1	0	0	0	1	1	2
152	Tyreke Evans	PG	28	MEM	52	32	1607	366	809	0452	114	286	0399	252	523	0482	0523	164	209	0785	44	221	265	269	57	17	117	96	1010
153	Dante Exum	PG	22	UTA	14	0	235	42	87	0483	5	18	0278	37	69	0536	0511	25	31	0806	4	22	26	43	8	3	20	20	114
154	Kenneth Faried	PF	28	DEN	32	7	461	76	148	0514	0	1	0000	76	147	0517	0514	36	51	0706	68	85	153	18	12	13	23	51	188
155	Derrick Favors	C	26	UTA	77	77	2153	395	702	0563	14	63	0222	381	639	0596	0573	140	215	0651	198	354	552	102	54	82	88	164	944
156	Kay Felder	PG	22	TOT	16	0	140	21	70	0300	4	19	0211	17	51	0333	0329	11	12	0917	3	15	18	20	3	1	16	11	57
156	Kay Felder	PG	22	CHI	14	0	134	20	66	0303	4	18	0222	16	48	0333	0333	11	12	0917	1	13	14	20	3	1	15	11	55
156	Kay Felder	PG	22	DET	2	0	6	1	4	0250	0	1	0000	1	3	0333	0250	0	0	0	2	2	4	0	0	0	1	0	2
157	Cristiano Felício	C	25	CHI	55	16	977	127	215	0591	0	2	0000	127	213	0596	0591	54	81	0667	83	150	233	55	16	11	54	104	308
158	Raymond Felton	PG	33	OKC	82	2	1365	224	552	0406	81	230	0352	143	322	0444	0479	36	44	0818	25	131	156	203	49	16	76	91	565
159	Terrance Ferguson	SG	19	OKC	61	12	763	70	169	0414	40	120	0333	30	49	0612	0533	9	10	0900	19	28	47	19	24	10	11	83	189
160	Yogi Ferrell	SG	24	DAL	82	21	2282	311	730	0426	134	359	0373	177	371	0477	0518	82	103	0796	26	223	249	201	64	9	78	153	838
161	Dorian Finney-Smith	PF	24	DAL	21	13	448	46	121	0380	20	67	0299	26	54	0481	0463	11	15	0733	22	53	75	26	10	4	21	43	123
162	Bryn Forbes	SG	24	SAS	80	12	1517	209	497	0421	89	228	0390	120	269	0446	0510	48	72	0667	12	98	110	80	28	2	37	108	555
163	Evan Fournier	SF	25	ORL	57	57	1837	368	802	0459	127	335	0379	241	467	0516	0538	150	173	0867	23	157	180	165	47	16	95	138	1013
164	De'Aaron Fox	PG	20	SAC	73	60	2026	328	797	0412	47	153	0307	281	644	0436	0441	141	195	0723	33	171	204	320	70	20	173	163	844
165	Tim Frazier	PG	27	WAS	59	11	838	68	172	0395	17	56	0304	51	116	0440	0445	23	30	0767	18	97	115	194	47	7	57	97	176
166	Enes Freedom	C	25	NYK	71	71	1830	422	713	0592	0	2	0000	422	711	0594	0592	156	184	0848	273	507	780	105	36	37	122	187	1000
167	Channing Frye	C	34	TOT	53	1	695	104	212	0491	39	115	0339	65	97	0670	0583	17	19	0895	12	123	135	38	18	13	21	69	264
167	Channing Frye	C	34	CLE	44	1	545	84	169	0497	30	90	0333	54	79	0684	0586	14	15	0933	10	100	110	28	17	12	17	54	212
167	Channing Frye	C	34	LAL	9	0	150	20	43	0465	9	25	0360	11	18	0611	0570	3	4	0750	2	23	25	10	1	1	4	15	52
168	Markelle Fultz	SG	19	PHI	14	0	253	45	111	0405	0	1	0000	45	110	0409	0405	10	21	0476	11	32	43	53	12	4	17	22	100
169	Danilo Gallinari	SF	29	LAC	21	21	671	102	256	0398	36	111	0324	66	145	0455	0469	81	87	0931	9	92	101	41	12	10	26	30	321
170	Langston Galloway	SG	26	DET	58	2	863	126	340	0371	75	218	0344	51	122	0418	0481	33	41	0805	13	79	92	58	35	5	18	39	360
171	Marc Gasol	C	33	MEM	73	73	2408	434	1033	0420	109	320	0341	325	713	0456	0473	281	337	0834	78	514	592	305	54	101	194	185	1258
172	Pau Gasol	C	37	SAS	77	63	1812	287	627	0458	43	120	0358	244	507	0481	0492	158	209	0756	129	490	619	238	24	79	108	121	775
173	Rudy Gay	PF	31	SAS	57	6	1231	253	537	0471	37	118	0314	216	419	0516	0506	112	145	0772	76	215	291	73	46	38	78	98	655
174	Paul George	SF	27	OKC	79	79	2891	576	1340	0430	244	609	0401	332	731	0454	0521	338	411	0822	72	375	447	263	161	39	212	233	1734
175	Marcus Georges-Hunt	SG	23	MIN	42	0	224	21	48	0438	4	15	0267	17	33	0515	0479	13	21	0619	7	9	16	7	6	0	3	32	59
176	Jonathan Gibson	PG	30	BOS	4	0	40	14	23	0609	6	12	0500	8	11	0727	0739	0	0	0	0	3	3	4	0	0	3	5	34
177	Taj Gibson	PF	32	MIN	82	82	2726	425	737	0577	7	35	0200	418	702	0595	0581	142	185	0768	194	390	584	99	62	59	89	218	999
178	Manu Ginóbili*	SG	40	SAS	65	0	1299	201	463	0434	64	192	0333	137	271	0506	0503	110	131	0840	19	123	142	163	43	16	105	126	576
179	Rudy Gobert	C	25	UTA	56	56	1816	276	444	0622	0	0	0	276	444	0622	0622	204	299	0682	165	436	601	80	44	129	107	153	756
180	Aaron Gordon	PF	22	ORL	58	57	1909	375	865	0434	115	342	0336	260	523	0497	0500	157	225	0698	87	370	457	136	59	45	107	111	1022
181	Eric Gordon	SG	29	HOU	69	30	2154	415	970	0428	218	608	0359	197	362	0544	0540	195	241	0809	25	145	170	154	44	27	130	116	1243
182	Marcin Gortat	C	33	WAS	82	82	2075	290	560	0518	0	0	0	290	560	0518	0518	110	163	0675	181	442	623	151	40	61	99	175	690
183	Treveon Graham	SG	24	CHO	63	2	1050	96	221	0434	40	97	0412	56	124	0452	0525	41	59	0695	42	79	121	59	33	2	27	109	273
184	Jerami Grant	PF	23	OKC	81	1	1647	244	456	0535	32	110	0291	212	346	0613	0570	162	240	0675	86	233	319	57	31	77	54	155	682
185	Jerian Grant	PG	25	CHI	74	26	1686	209	503	0416	61	187	0326	148	316	0468	0476	140	188	0745	31	141	172	342	63	8	89	132	619
186	Josh Gray	PG	24	PHO	5	0	86	11	41	0268	3	13	0231	8	28	0286	0305	7	11	0636	2	8	10	12	8	2	7	8	32
187	Danny Green	SG	30	SAS	70	60	1791	217	561	0387	116	320	0363	101	241	0419	0490	50	65	0769	41	208	249	110	63	80	74	122	600
188	Draymond Green	PF	27	GSW	70	70	2287	281	619	0454	77	256	0301	204	363	0562	0516	134	173	0775	75	460	535	508	95	91	202	185	773
189	Gerald Green	SG	32	HOU	41	2	929	168	413	0407	110	298	0369	58	115	0504	0540	51	60	0850	15	118	133	25	24	15	31	87	497
190	JaMychal Green	PF	27	MEM	55	54	1542	223	488	0457	43	127	0339	180	361	0499	0501	80	111	0721	147	317	464	79	32	25	76	153	569
191	Jeff Green	PF	31	CLE	78	13	1828	295	618	0477	53	170	0312	242	448	0540	0520	203	234	0868	60	186	246	99	41	34	75	149	846
192	Blake Griffin	PF	28	TOT	58	58	1970	436	996	0438	111	322	0345	325	674	0482	0493	259	330	0785	73	355	428	334	41	18	165	139	1242
192	Blake Griffin	PF	28	LAC	33	33	1139	255	578	0441	64	187	0342	191	391	0488	0497	172	219	0785	46	216	262	179	30	9	99	78	746
192	Blake Griffin	PF	28	DET	25	25	831	181	418	0433	47	135	0348	134	283	0473	0489	87	111	0784	27	139	166	155	11	9	66	61	496
193	Daniel Hamilton	SG	22	OKC	6	0	28	5	11	0455	2	5	0400	3	6	0500	0545	0	0	0	0	5	5	8	1	0	2	2	12
194	Tim Hardaway Jr0	SG	25	NYK	57	54	1885	360	856	0421	130	410	0317	230	446	0516	0496	146	179	0816	32	192	224	155	62	10	92	123	996
195	James Harden	SG	28	HOU	72	72	2551	651	1449	0449	265	722	0367	386	727	0531	0541	624	727	0858	41	348	389	630	126	50	315	169	2191
196	Maurice Harkless	SF	24	POR	59	36	1264	147	297	0495	49	118	0415	98	179	0547	0577	42	59	0712	46	116	162	53	48	43	40	103	385
197	Montrezl Harrell	C	24	LAC	76	3	1293	348	548	0635	1	7	0143	347	541	0641	0636	139	222	0626	103	203	306	74	36	52	68	143	836
198	Devin Harris	PG	34	TOT	71	1	1340	187	454	0412	79	227	0348	108	227	0476	0499	142	170	0835	12	115	127	152	47	12	76	158	595
198	Devin Harris	PG	34	DAL	44	1	807	118	284	0415	44	125	0352	74	159	0465	0493	93	112	0830	9	76	85	85	33	8	49	103	373
198	Devin Harris	PG	34	DEN	27	0	533	69	170	0406	35	102	0343	34	68	0500	0509	49	58	0845	3	39	42	67	14	4	27	55	222
199	Gary Harris	SG	23	DEN	67	65	2304	440	908	0485	156	394	0396	284	514	0553	0570	134	162	0827	37	139	176	194	122	15	119	119	1170
200	Joe Harris	SG	26	BRK	78	14	1975	305	621	0491	150	358	0419	155	263	0589	0612	86	104	0827	51	209	260	128	35	20	91	153	846
201	Tobias Harris	PF	25	TOT	80	80	2668	562	1221	0460	183	445	0411	379	776	0488	0535	179	216	0829	58	379	437	192	71	35	105	164	1486
201	Tobias Harris	PF	25	DET	48	48	1563	320	709	0451	113	276	0409	207	433	0478	0531	115	136	0846	36	208	244	94	34	15	51	91	868
201	Tobias Harris	PF	25	LAC	32	32	1105	242	512	0473	70	169	0414	172	343	0501	0541	64	80	0800	22	171	193	98	37	20	54	73	618
202	Aaron Harrison	SG	23	DAL	9	3	233	19	69	0275	9	43	0209	10	26	0385	0341	13	17	0765	4	20	24	11	9	2	3	27	60
203	Andrew Harrison	PG	23	MEM	56	46	1326	181	429	0422	47	142	0331	134	287	0467	0477	124	159	0780	23	108	131	177	38	26	81	138	533
204	Shaquille Harrison	PG	24	PHO	23	2	384	59	124	0476	6	26	0231	53	98	0541	0500	28	38	0737	9	52	61	55	26	7	22	42	152
205	Josh Hart	SG	22	LAL	63	23	1461	176	375	0469	78	197	0396	98	178	0551	0573	66	94	0702	42	221	263	80	47	16	47	107	496
206	Udonis Haslem	C	37	MIA	14	0	72	3	15	0200	1	8	0125	2	7	0286	0233	1	2	0500	3	7	10	5	0	2	2	3	8
207	Nigel Hayes	SF	23	TOT	9	0	122	11	33	0333	4	16	0250	7	17	0412	0394	1	3	0333	4	18	22	6	2	3	2	8	27
207	Nigel Hayes	SF	23	LAL	2	0	11	1	3	0333	0	2	0000	1	1	10000	0333	1	1	10000	0	0	0	2	0	0	0	0	3
207	Nigel Hayes	SF	23	TOR	2	0	6	2	2	10000	2	2	10000	0	0	0	10500	0	0	0	0	0	0	0	0	0	1	0	6
207	Nigel Hayes	SF	23	SAC	5	0	105	8	28	0286	2	12	0167	6	16	0375	0321	0	2	0000	4	18	22	4	2	3	1	8	18
208	Gordon Hayward	SF	27	BOS	1	1	5	1	2	0500	0	1	0000	1	1	10000	0500	0	0	0	0	1	1	0	0	0	0	1	2
209	Reggie Hearn	SG	26	DET	3	0	7	1	2	0500	1	2	0500	0	0	0	0750	0	0	0	0	0	0	0	0	0	0	0	3
210	Myke Henry	SF	25	MEM	20	0	378	41	109	0376	19	58	0328	22	51	0431	0463	6	10	0600	10	28	38	22	31	6	19	28	107
211	John Henson	C	27	MIL	76	69	1970	287	502	0572	1	7	0143	286	495	0578	0573	90	158	0570	150	363	513	114	45	109	84	202	665
212	Juancho Hernangómez	PF	22	DEN	25	3	277	29	75	0387	14	50	0280	15	25	0600	0480	10	12	0833	18	36	54	12	6	3	9	25	82
213	Willy Hernangómez	C	23	TOT	48	1	495	91	164	0555	5	12	0417	86	152	0566	0570	59	90	0656	61	122	183	33	18	16	35	64	246
213	Willy Hernangómez	C	23	NYK	26	0	233	49	81	0605	1	5	0200	48	76	0632	0611	12	28	0429	22	45	67	21	8	7	26	32	111
213	Willy Hernangómez	C	23	CHO	22	1	262	42	83	0506	4	7	0571	38	76	0500	0530	47	62	0758	39	77	116	12	10	9	9	32	135
214	Mario Hezonja	SF	22	ORL	75	30	1657	273	617	0442	90	267	0337	183	350	0523	0515	86	105	0819	41	240	281	106	81	31	86	134	722
215	Isaiah Hicks	PF	23	NYK	18	0	240	33	72	0458	2	9	0222	31	63	0492	0472	12	18	0667	10	31	41	16	2	4	16	45	80
216	Buddy Hield	SG	25	SAC	80	12	2024	416	933	0446	176	408	0431	240	525	0457	0540	71	81	0877	55	252	307	155	85	22	124	148	1079
217	Nenê	C	35	HOU	52	4	758	136	239	0569	0	2	0000	136	237	0574	0569	68	107	0636	54	122	176	45	28	14	38	123	340
218	George Hill	PG	31	TOT	67	60	1812	236	513	0460	85	205	0415	151	308	0490	0543	110	140	0786	42	139	181	186	61	27	88	128	667
218	George Hill	PG	31	SAC	43	36	1143	153	326	0469	58	128	0453	95	198	0480	0558	77	99	0778	22	95	117	119	39	12	60	75	441
218	George Hill	PG	31	CLE	24	24	669	83	187	0444	27	77	0351	56	110	0509	0516	33	41	0805	20	44	64	67	22	15	28	53	226
219	Solomon Hill	SF	26	NOP	12	1	187	11	41	0268	4	21	0190	7	20	0350	0317	3	6	0500	9	27	36	22	7	1	9	22	29
220	Darrun Hilliard	SG	24	SAS	14	0	95	5	19	0263	0	6	0000	5	13	0385	0263	6	7	0857	0	7	7	11	2	0	4	7	16
221	Jrue Holiday	SG	27	NOP	81	81	2927	615	1244	0494	120	356	0337	495	888	0557	0543	187	238	0786	62	303	365	486	123	64	213	201	1537
222	Justin Holiday	SG	28	CHI	72	72	2265	290	782	0371	161	449	0359	129	333	0387	0474	135	164	0823	31	260	291	153	80	31	93	134	876
223	John Holland	SF	29	CLE	24	0	174	17	59	0288	11	36	0306	6	23	0261	0381	9	13	0692	6	18	24	5	7	2	8	10	54
224	Rondae Hollis-Jefferson	SF	23	BRK	68	59	1920	342	724	0472	13	54	0241	329	670	0491	0481	249	316	0788	101	358	459	167	65	48	121	145	946
225	Richaun Holmes	C	24	PHI	48	2	746	135	241	0560	4	31	0129	131	210	0624	0568	37	56	0661	57	154	211	61	20	29	25	97	311
226	Rodney Hood	SG	25	TOT	60	23	1616	322	751	0429	127	333	0381	195	418	0467	0513	111	129	0860	22	143	165	95	45	12	70	105	882
226	Rodney Hood	SG	25	UTA	39	12	1084	234	552	0424	102	262	0389	132	290	0455	0516	85	97	0876	14	97	111	65	30	7	63	64	655
226	Rodney Hood	SG	25	CLE	21	11	532	88	199	0442	25	71	0352	63	128	0492	0505	26	32	0813	8	46	54	30	15	5	7	41	227
227	Scotty Hopson	SG	28	DAL	1	0	8	0	1	0000	0	0	0	0	1	0000	0000	1	2	0500	0	0	0	1	0	0	1	0	1
228	Al Horford	C	31	BOS	72	72	2277	368	753	0489	97	226	0429	271	527	0514	0553	94	120	0783	103	427	530	339	43	78	132	138	927
229	Danuel House Jr0	SG	24	PHO	23	3	403	56	129	0434	15	58	0259	41	71	0577	0492	25	31	0806	13	63	76	25	7	6	11	23	152
230	Dwight Howard	C	32	CHO	81	81	2463	506	911	0555	1	7	0143	505	904	0559	0556	334	582	0574	255	757	1012	105	48	131	208	249	1347
231	Josh Huestis	PF	26	OKC	69	10	982	60	182	0330	33	115	0287	27	67	0403	0420	6	20	0300	42	119	161	20	15	43	26	82	159
232	R0J0 Hunter	SG	24	HOU	5	1	45	7	20	0350	3	14	0214	4	6	0667	0425	2	2	10000	0	5	5	3	3	0	2	7	19
233	Vince Hunter	PF	23	MEM	4	0	7	3	5	0600	0	0	0	3	5	0600	0600	0	0	0	2	1	3	0	0	1	1	0	6
234	Serge Ibaka	PF	28	TOR	76	76	2093	379	784	0483	107	297	0360	272	487	0559	0552	94	118	0797	78	400	478	62	29	99	90	209	959
235	Andre Iguodala	SF	34	GSW	64	7	1622	148	320	0463	33	117	0282	115	203	0567	0514	55	87	0632	50	196	246	210	54	38	67	99	384
236	Ersan İlyasova	PF	30	TOT	69	43	1729	277	613	0452	91	253	0360	186	360	0517	0526	105	135	0778	118	287	405	90	61	26	72	157	750
236	Ersan İlyasova	PF	30	ATL	46	40	1175	184	401	0459	61	170	0359	123	231	0532	0535	72	90	0800	74	177	251	51	44	17	43	92	501
236	Ersan İlyasova	PF	30	PHI	23	3	554	93	212	0439	30	83	0361	63	129	0488	0509	33	45	0733	44	110	154	39	17	9	29	65	249
237	Joe Ingles	SF	30	UTA	82	81	2578	335	718	0467	204	464	0440	131	254	0516	0609	66	83	0795	24	320	344	392	90	20	159	178	940
238	Andre Ingram	SG	32	LAL	2	0	64	8	17	0471	5	9	0556	3	8	0375	0618	3	3	10000	1	5	6	7	3	3	3	3	24
239	Brandon Ingram	SF	20	LAL	59	59	1975	358	761	0470	41	105	0390	317	656	0483	0497	192	282	0681	57	257	314	230	45	43	149	163	949
240	Kyrie Irving	PG	25	BOS	60	60	1931	534	1087	0491	166	407	0408	368	680	0541	0568	232	261	0889	33	194	227	306	65	17	140	122	1466
241	Jonathan Isaac	PF	20	ORL	27	10	536	55	145	0379	16	46	0348	39	99	0394	0434	19	25	0760	16	83	99	18	33	30	27	48	145
242	Wes Iwundu	SF	23	ORL	62	12	1020	93	218	0427	9	46	0196	84	172	0488	0447	34	47	0723	36	101	137	57	33	12	30	81	229
243	Jarrett Jack	PG	34	NYK	62	56	1548	189	443	0427	25	86	0291	164	357	0459	0455	63	75	0840	22	169	191	348	35	4	115	98	466
244	Aaron Jackson	PG	31	HOU	1	0	35	3	9	0333	1	4	0250	2	5	0400	0389	1	2	0500	2	1	3	1	0	0	1	4	8
245	Demetrius Jackson	PG	23	TOT	15	0	80	7	18	0389	1	7	0143	6	11	0545	0417	1	2	0500	5	7	12	9	5	1	10	7	16
245	Demetrius Jackson	PG	23	HOU	12	0	63	4	14	0286	0	6	0000	4	8	0500	0286	0	0	0	4	7	11	5	4	1	9	6	8
245	Demetrius Jackson	PG	23	PHI	3	0	17	3	4	0750	1	1	10000	2	3	0667	0875	1	2	0500	1	0	1	4	1	0	1	1	8
246	Josh Jackson	SF	20	PHO	77	35	1959	389	932	0417	57	217	0263	332	715	0464	0448	177	279	0634	95	256	351	119	80	35	146	218	1012
247	Justin Jackson	SF	22	SAC	68	41	1506	185	419	0442	57	185	0308	128	234	0547	0510	26	36	0722	27	160	187	74	28	13	40	81	453
248	Reggie Jackson	PG	27	DET	45	45	1201	246	577	0426	52	169	0308	194	408	0475	0471	112	134	0836	29	96	125	238	27	4	99	87	656
249	LeBron James	PF	33	CLE	82	82	3026	857	1580	0542	149	406	0367	708	1174	0603	0590	388	531	0731	97	612	709	747	116	71	347	136	2251
250	Mike James	PG	27	TOT	36	10	687	123	321	0383	26	98	0265	97	223	0435	0424	64	84	0762	13	77	90	126	28	7	49	48	336
250	Mike James	PG	27	PHO	32	10	669	121	312	0388	26	97	0268	95	215	0442	0429	64	84	0762	12	77	89	120	27	7	48	45	332
250	Mike James	PG	27	NOP	4	0	18	2	9	0222	0	1	0000	2	8	0250	0222	0	0	0	1	0	1	6	1	0	1	3	4
251	Al Jefferson	C	33	IND	36	1	484	111	208	0534	0	3	0000	111	205	0541	0534	30	36	0833	30	113	143	30	16	23	21	66	252
252	Richard Jefferson	SF	37	DEN	20	0	163	12	27	0444	2	7	0286	10	20	0500	0481	4	7	0571	2	15	17	15	2	1	5	11	30
253	Brandon Jennings	PG	28	MIL	14	0	205	27	72	0375	9	33	0273	18	39	0462	0438	10	10	10000	5	26	31	44	6	4	18	11	73
254	Jonas Jerebko	PF	30	UTA	74	19	1134	159	341	0466	65	157	0414	94	184	0511	0562	46	57	0807	53	193	246	42	24	12	27	127	429
255	Amir Johnson	C	30	PHI	74	18	1171	140	260	0538	10	32	0313	130	228	0570	0558	52	85	0612	123	207	330	118	45	44	55	192	342
256	Brice Johnson	PF	23	TOT	18	0	98	20	42	0476	0	1	0000	20	41	0488	0476	3	5	0600	9	22	31	2	9	6	5	13	43
256	Brice Johnson	PF	23	LAC	9	0	38	7	11	0636	0	1	0000	7	10	0700	0636	2	2	10000	2	11	13	1	6	2	4	7	16
256	Brice Johnson	PF	23	MEM	9	0	60	13	31	0419	0	0	0	13	31	0419	0419	1	3	0333	7	11	18	1	3	4	1	6	27
257	Dakari Johnson	C	22	OKC	31	6	161	22	39	0564	0	0	0	22	39	0564	0564	11	20	0550	16	18	34	8	6	8	3	27	55
258	James Johnson	PF	30	MIA	73	41	1943	309	614	0503	57	185	0308	252	429	0587	0550	113	162	0698	61	297	358	280	70	51	141	192	788
259	Joe Johnson	SF	36	TOT	55	4	1205	146	360	0406	40	145	0276	106	215	0493	0461	40	45	0889	14	158	172	83	18	7	49	67	372
259	Joe Johnson	SF	36	UTA	32	3	700	95	226	0420	23	84	0274	72	142	0507	0471	20	24	0833	12	95	107	45	12	6	31	32	233
259	Joe Johnson	SF	36	HOU	23	1	505	51	134	0381	17	61	0279	34	73	0466	0444	20	21	0952	2	63	65	38	6	1	18	35	139
260	Omari Johnson	PF	28	MEM	4	0	75	9	21	0429	4	12	0333	5	9	0556	0524	0	0	0	4	7	11	7	2	0	3	6	22
261	Stanley Johnson	SF	21	DET	69	50	1894	210	560	0375	67	234	0286	143	326	0439	0435	112	145	0772	33	219	252	112	95	14	77	169	599
262	Tyler Johnson	PG	25	MIA	72	39	2052	309	711	0435	119	324	0367	190	387	0491	0518	106	129	0822	34	214	248	165	60	34	81	148	843
263	Wesley Johnson	SF	30	LAC	74	40	1486	150	368	0408	60	177	0339	90	191	0471	0489	43	58	0741	29	187	216	61	76	62	55	146	403
264	Nikola Jokić	C	22	DEN	75	73	2443	504	1010	0499	111	280	0396	393	730	0538	0554	266	313	0850	195	608	803	458	90	61	210	212	1385
265	Damian Jones	C	22	GSW	15	0	89	11	22	0500	0	0	0	11	22	0500	0500	3	5	0600	5	9	14	2	1	3	4	14	25
266	Derrick Jones Jr0	SF	20	TOT	20	8	245	21	53	0396	3	18	0167	18	35	0514	0425	16	24	0667	21	17	38	9	4	13	7	24	61
266	Derrick Jones Jr0	SF	20	PHO	6	0	33	2	4	0500	0	2	0000	2	2	10000	0500	5	6	0833	2	2	4	3	1	4	1	2	9
266	Derrick Jones Jr0	SF	20	MIA	14	8	212	19	49	0388	3	16	0188	16	33	0485	0418	11	18	0611	19	15	34	6	3	9	6	22	52
267	Jalen Jones	SF	24	TOT	16	0	181	26	68	0382	10	26	0385	16	42	0381	0456	12	19	0632	13	25	38	4	5	1	7	22	74
267	Jalen Jones	SF	24	NOP	4	0	19	1	4	0250	1	1	10000	0	3	0000	0375	2	2	10000	0	3	3	0	0	0	0	2	5
267	Jalen Jones	SF	24	DAL	12	0	162	25	64	0391	9	25	0360	16	39	0410	0461	10	17	0588	13	22	35	4	5	1	7	20	69
268	Tyus Jones	PG	21	MIN	82	11	1467	150	328	0457	45	129	0349	105	199	0528	0526	71	81	0877	16	116	132	232	95	6	59	110	416
269	DeAndre Jordan	C	29	LAC	77	77	2424	373	578	0645	0	0	0	373	578	0645	0645	181	312	0580	329	842	1171	117	39	71	137	203	927
270	Cory Joseph	PG	26	IND	82	17	2210	256	604	0424	67	190	0353	189	414	0457	0479	70	94	0745	39	224	263	260	80	18	87	141	649
271	Frank Kaminsky	PF	24	CHO	79	4	1835	307	716	0429	104	274	0380	203	442	0459	0501	155	194	0799	46	242	288	129	36	19	66	95	873
272	Luke Kennard	SG	21	DET	73	9	1463	206	465	0443	81	195	0415	125	270	0463	0530	65	76	0855	21	155	176	124	44	13	69	86	558
273	Michael Kidd-Gilchrist	SF	24	CHO	74	74	1850	282	560	0504	0	2	0000	282	558	0505	0504	117	171	0684	84	218	302	71	51	32	53	143	681
274	Sean Kilpatrick	SG	28	TOT	52	1	640	110	294	0374	46	144	0319	64	150	0427	0452	64	72	0889	5	82	87	46	13	5	38	33	330
274	Sean Kilpatrick	SG	28	BRK	16	0	183	25	87	0287	11	43	0256	14	44	0318	0351	18	19	0947	1	34	35	15	2	1	16	8	79
274	Sean Kilpatrick	SG	28	MIL	23	0	205	31	82	0378	13	46	0283	18	36	0500	0457	18	19	0947	1	24	25	15	5	1	9	15	93
274	Sean Kilpatrick	SG	28	LAC	4	0	38	7	18	0389	3	7	0429	4	11	0364	0472	2	2	10000	0	2	2	3	0	0	1	2	19
274	Sean Kilpatrick	SG	28	CHI	9	1	214	47	107	0439	19	48	0396	28	59	0475	0528	26	32	0813	3	22	25	13	6	3	12	8	139
275	Maxi Kleber	PF	26	DAL	72	36	1206	151	309	0489	40	128	0313	111	181	0613	0553	44	59	0746	71	163	234	51	26	47	30	114	386
276	Furkan Korkmaz	SG	20	PHI	14	0	80	8	28	0286	5	17	0294	3	11	0273	0375	2	4	0500	2	9	11	4	2	1	2	12	23
277	Luke Kornet	C	22	NYK	20	1	326	49	125	0392	28	79	0354	21	46	0457	0504	8	11	0727	11	53	64	26	6	16	12	28	134
278	Kyle Korver	SG	36	CLE	73	4	1574	222	484	0459	164	376	0436	58	108	0537	0628	64	72	0889	9	156	165	88	31	27	55	130	672
279	Kosta Koufos	C	28	SAC	71	13	1391	222	389	0571	0	0	0	222	389	0571	0571	33	74	0446	149	323	472	87	47	32	49	146	477
280	Kyle Kuzma	PF	22	LAL	77	37	2401	468	1039	0450	159	434	0366	309	605	0511	0527	147	208	0707	88	395	483	141	49	34	140	160	1242
281	Mindaugas Kuzminskas	SF	28	NYK	1	0	2	0	2	0000	0	0	0	0	2	0000	0000	0	0	0	0	0	0	0	0	0	0	0	0
282	Skal Labissière	PF	21	SAC	60	28	1240	205	458	0448	18	51	0353	187	407	0459	0467	95	118	0805	99	189	288	72	25	49	73	132	523
283	Jeremy Lamb	SG	25	CHO	80	18	1967	380	832	0457	94	254	0370	286	578	0495	0513	179	208	0861	49	275	324	186	61	32	93	138	1033
284	Shane Larkin	PG	25	BOS	54	2	775	84	219	0384	31	86	0360	53	133	0398	0454	32	37	0865	15	77	92	98	29	2	33	58	231
285	Joffrey Lauvergne	C	26	SAS	55	1	534	98	190	0516	0	5	0000	98	185	0530	0516	30	47	0638	63	108	171	41	9	3	33	45	226
286	Zach LaVine	SG	22	CHI	24	24	656	136	355	0383	42	123	0341	94	232	0405	0442	87	107	0813	9	85	94	72	24	4	43	55	401
287	Jake Layman	SF	23	POR	35	1	160	14	47	0298	4	20	0200	10	27	0370	0340	2	3	0667	4	12	16	11	6	4	5	13	34
288	T0J0 Leaf	PF	20	IND	53	0	459	64	136	0471	18	42	0429	46	94	0489	0537	10	16	0625	29	53	82	9	5	4	10	45	156
289	Courtney Lee	SG	32	NYK	76	69	2310	343	755	0454	113	278	0406	230	477	0482	0529	114	124	0919	30	194	224	180	80	17	84	109	913
290	Damion Lee	SG	25	ATL	15	11	404	62	152	0408	15	60	0250	47	92	0511	0457	22	29	0759	11	60	71	29	19	1	14	25	161
291	Walt Lemon Jr0	PG	25	NOP	5	0	35	7	16	0438	1	1	10000	6	15	0400	0469	2	3	0667	0	2	2	5	0	1	4	5	17
292	Alex Len	C	24	PHO	69	13	1395	214	378	0566	1	3	0333	213	375	0568	0567	158	231	0684	175	343	518	82	27	61	78	158	587
293	Kawhi Leonard	SF	26	SAS	9	9	210	52	111	0468	11	35	0314	41	76	0539	0518	31	38	0816	6	36	42	21	18	9	16	9	146
294	Meyers Leonard	C	25	POR	33	2	254	46	78	0590	11	26	0423	35	52	0673	0660	9	11	0818	12	58	70	17	7	0	10	36	112
295	Jon Leuer	PF	28	DET	8	0	136	15	36	0417	0	3	0000	15	33	0455	0417	13	15	0867	7	25	32	5	1	3	7	16	43
296	Caris LeVert	SF	23	BRK	71	10	1864	320	735	0435	85	245	0347	235	490	0480	0493	133	187	0711	53	207	260	299	82	22	153	159	858
297	DeAndre Liggins	SG	29	TOT	58	4	724	40	106	0377	19	53	0358	21	53	0396	0467	2	5	0400	7	68	75	48	37	14	20	81	101
297	DeAndre Liggins	SG	29	MIL	31	1	480	22	65	0338	11	36	0306	11	29	0379	0423	2	5	0400	5	44	49	27	27	10	13	61	57
297	DeAndre Liggins	SG	29	NOP	27	3	244	18	41	0439	8	17	0471	10	24	0417	0537	0	0	0	2	24	26	21	10	4	7	20	44
298	Damian Lillard	PG	27	POR	73	73	2670	621	1415	0439	227	629	0361	394	786	0501	0519	493	538	0916	62	263	325	481	77	27	206	117	1962
299	Jeremy Lin	PG	29	BRK	1	1	25	5	12	0417	1	2	0500	4	10	0400	0458	7	7	10000	0	0	0	4	0	0	3	3	18
300	Shaun Livingston	PG	32	GSW	71	7	1129	172	343	0501	0	5	0000	172	338	0509	0501	50	61	0820	32	99	131	140	35	21	58	117	394
301	Kevon Looney	C	21	GSW	66	4	910	112	193	0580	1	5	0200	111	188	0590	0583	42	77	0545	83	132	215	42	34	56	31	106	267
302	Brook Lopez	C	29	LAL	74	72	1735	369	793	0465	112	325	0345	257	468	0549	0536	111	158	0703	74	220	294	126	30	98	98	195	961
303	Robin Lopez	C	29	CHI	64	64	1690	342	645	0530	4	14	0286	338	631	0536	0533	68	90	0756	134	156	290	124	14	53	107	109	756
304	Kevin Love	C	29	CLE	59	59	1651	334	729	0458	137	330	0415	197	399	0494	0552	234	266	0880	101	445	546	103	43	24	90	120	1039
305	Kyle Lowry	PG	31	TOR	78	78	2510	403	944	0427	238	596	0399	165	348	0474	0553	223	261	0854	66	368	434	537	85	19	183	192	1267
306	Timothé Luwawu-Cabarrot	SF	22	PHI	52	7	807	100	267	0375	53	158	0335	47	109	0431	0474	46	58	0793	14	58	72	54	12	5	38	97	299
307	Tyler Lydon	PF	21	DEN	1	0	2	0	0	0	0	0	0	0	0	0	0	0	0	0	0	0	0	0	0	0	0	0	0
308	Trey Lyles	PF	22	DEN	73	2	1391	270	550	0491	83	218	0381	187	332	0563	0566	101	143	0706	55	292	347	91	30	34	61	111	724
309	Shelvin Mack	PG	27	ORL	69	3	1365	178	414	0430	48	139	0345	130	275	0473	0488	69	97	0711	23	143	166	272	54	8	89	91	473
310	Josh Magette	PG	28	ATL	18	0	216	15	46	0326	8	22	0364	7	24	0292	0413	8	8	10000	2	17	19	57	8	1	9	16	46
311	Ian Mahinmi	C	31	WAS	77	0	1145	138	248	0556	0	2	0000	138	246	0561	0556	90	128	0703	135	177	312	53	38	42	100	230	366
312	Thon Maker	C	20	MIL	74	12	1238	130	316	0411	31	104	0298	99	212	0467	0460	65	93	0699	75	150	225	46	38	53	44	162	356
313	Boban Marjanović	C	29	TOT	39	1	337	79	148	0534	0	0	0	79	148	0534	0534	77	97	0794	48	96	144	22	10	11	36	51	235
313	Boban Marjanović	C	29	DET	19	1	171	41	79	0519	0	0	0	41	79	0519	0519	36	45	0800	15	42	57	14	4	6	22	28	118
313	Boban Marjanović	C	29	LAC	20	0	166	38	69	0551	0	0	0	38	69	0551	0551	41	52	0788	33	54	87	8	6	5	14	23	117
314	Lauri Markkanen	PF	20	CHI	68	68	2020	374	862	0434	145	401	0362	229	461	0497	0518	140	166	0843	79	429	508	79	39	40	83	103	1033
315	Jarell Martin	PF	23	MEM	73	36	1661	221	496	0446	34	98	0347	187	398	0470	0480	89	116	0767	97	221	318	73	39	49	86	211	565
316	Frank Mason III	PG	23	SAC	52	2	984	144	380	0379	31	86	0360	113	294	0384	0420	94	115	0817	30	100	130	147	34	10	65	72	413
317	Mangok Mathiang	C	25	CHO	4	0	20	4	7	0571	0	0	0	4	7	0571	0571	0	1	0000	3	7	10	0	1	0	0	5	8
318	Wesley Matthews	SF	31	DAL	63	62	2131	283	697	0406	153	402	0381	130	295	0441	0516	83	101	0822	28	170	198	172	76	16	83	140	802
319	Luc Mbah a Moute	PF	31	HOU	61	15	1564	166	345	0481	63	173	0364	103	172	0599	0572	65	95	0684	22	164	186	55	72	25	68	100	460
320	James Michael McAdoo	PF	25	PHI	3	0	18	2	7	0286	2	7	0286	0	0	0	0429	2	2	10000	0	2	2	0	0	1	1	1	8
321	Patrick McCaw	SG	22	GSW	57	10	961	92	225	0409	19	80	0238	73	145	0503	0451	26	34	0765	16	66	82	81	43	10	41	67	229
322	CJ McCollum	SG	26	POR	81	81	2923	667	1505	0443	189	476	0397	478	1029	0465	0506	209	250	0836	53	268	321	272	77	35	151	168	1732
323	T0J0 McConnell	PG	25	PHI	76	1	1706	210	421	0499	27	62	0435	183	359	0510	0531	31	39	0795	37	189	226	303	92	13	112	122	478
324	Erik McCree	SF	24	UTA	4	0	8	0	2	0000	0	1	0000	0	1	0000	0000	0	0	0	0	1	1	0	1	0	1	0	0
325	Chris McCullough	PF	22	WAS	19	0	90	18	42	0429	1	8	0125	17	34	0500	0440	9	14	0643	7	18	25	4	0	5	2	8	46
326	Doug McDermott	SF	26	TOT	81	4	1768	237	508	0467	92	216	0426	145	292	0497	0557	64	81	0790	40	160	200	79	19	16	56	122	630
326	Doug McDermott	SF	26	NYK	55	1	1172	151	328	0460	53	137	0387	98	191	0513	0541	40	53	0755	33	101	134	50	10	12	34	73	395
326	Doug McDermott	SF	26	DAL	26	3	596	86	180	0478	39	79	0494	47	101	0465	0586	24	28	0857	7	59	66	29	9	4	22	49	235
327	JaVale McGee	C	30	GSW	65	17	615	136	219	0621	0	6	0000	136	213	0638	0621	38	52	0731	59	110	169	33	21	57	27	91	310
328	Rodney McGruder	SG	26	MIA	18	2	299	36	73	0493	15	35	0429	21	38	0553	0596	4	8	0500	11	22	33	17	8	3	4	21	91
329	Trey McKinney-Jones	SG	27	IND	1	0	1	0	0	0	0	0	0	0	0	0	0	0	0	0	0	0	0	0	0	0	0	0	0
330	Alfonzo McKinnie	SF	25	TOR	14	0	53	8	15	0533	3	9	0333	5	6	0833	0633	2	3	0667	1	6	7	1	1	1	3	8	21
331	Ben McLemore	SG	24	MEM	56	17	1091	157	373	0421	55	159	0346	102	214	0477	0495	53	64	0828	34	105	139	51	38	15	61	139	422
332	Josh McRoberts	PF	30	DAL	2	0	6	0	1	0000	0	1	0000	0	0	0	0000	0	0	0	0	0	0	0	0	0	0	2	0
333	Jodie Meeks	SG	30	WAS	77	0	1119	157	393	0399	72	210	0343	85	183	0464	0491	101	117	0863	15	111	126	70	29	4	37	55	487
334	Salah Mejri	C	31	DAL	61	1	729	88	137	0642	0	3	0000	88	134	0657	0642	38	66	0576	85	161	246	35	22	67	39	121	214
335	Jordan Mickey	PF	23	MIA	23	3	284	39	82	0476	2	16	0125	37	66	0561	0488	13	19	0684	18	63	81	9	6	10	18	36	93
336	Khris Middleton	SF	26	MIL	82	82	2982	593	1272	0466	146	407	0359	447	865	0517	0524	320	362	0884	45	384	429	328	119	21	191	270	1652
337	C0J0 Miles	SF	30	TOR	70	3	1337	227	599	0379	164	454	0361	63	145	0434	0516	81	97	0835	18	134	152	55	37	21	39	134	699
338	Darius Miller	SF	27	NOP	82	3	1944	216	487	0444	147	358	0411	69	129	0535	0594	58	67	0866	18	146	164	111	28	17	58	160	637
339	Malcolm Miller	SF	24	TOR	15	4	126	13	28	0464	8	21	0381	5	7	0714	0607	4	4	10000	4	11	15	3	1	2	5	10	38
340	Patty Mills	PG	29	SAS	82	36	2107	280	682	0411	154	414	0372	126	268	0470	0523	105	118	0890	26	128	154	229	55	11	106	128	819
341	Paul Millsap	PF	32	DEN	38	37	1143	202	435	0464	39	113	0345	163	322	0506	0509	112	161	0696	65	180	245	105	39	44	73	99	555
342	Nikola Mirotić	PF	26	TOT	55	14	1494	306	684	0447	135	358	0377	171	326	0525	0546	112	137	0818	59	346	405	80	44	39	62	108	859
342	Nikola Mirotić	PF	26	CHI	25	3	622	143	302	0474	69	161	0429	74	141	0525	0588	65	79	0823	18	141	159	39	15	13	31	45	420
342	Nikola Mirotić	PF	26	NOP	30	11	872	163	382	0427	66	197	0335	97	185	0524	0513	47	58	0810	41	205	246	41	29	26	31	63	439
343	Donovan Mitchell	SG	21	UTA	79	71	2638	595	1362	0437	187	550	0340	408	812	0502	0506	239	297	0805	52	244	296	291	118	27	215	213	1616
344	Naz Mitrou-Long	SG	24	UTA	1	0	1	1	1	10000	1	1	10000	0	0	0	10500	0	0	0	0	0	0	0	0	0	0	0	3
345	Malik Monk	SG	19	CHO	63	0	854	153	425	0360	83	243	0342	70	182	0385	0458	32	38	0842	8	58	66	91	20	9	49	60	421
346	Greg Monroe	C	27	TOT	51	14	1040	218	386	0565	0	0	0	218	386	0565	0565	88	119	0739	109	241	350	114	44	23	94	95	524
346	Greg Monroe	C	27	MIL	5	0	79	16	33	0485	0	0	0	16	33	0485	0485	2	4	0500	6	19	25	5	0	0	6	7	34
346	Greg Monroe	C	27	PHO	20	14	465	97	155	0626	0	0	0	97	155	0626	0626	31	46	0674	50	110	160	50	16	6	40	40	225
346	Greg Monroe	C	27	BOS	26	0	496	105	198	0530	0	0	0	105	198	0530	0530	55	69	0797	53	112	165	59	28	17	48	48	265
347	Luis Montero	SG	24	DET	2	0	8	0	1	0000	0	0	0	0	1	0000	0000	0	0	0	0	2	2	0	0	0	2	0	0
348	Ben Moore	PF	22	IND	2	0	9	0	0	0	0	0	0	0	0	0	0	0	0	0	0	1	1	1	0	0	0	4	0
349	E'Twaun Moore	SG	28	NOP	82	80	2586	423	832	0508	128	301	0425	295	531	0556	0585	48	68	0706	57	181	238	187	79	12	102	182	1022
350	Eric Moreland	PF	26	DET	67	3	805	66	122	0541	0	0	0	66	122	0541	0541	11	29	0379	81	197	278	78	31	51	42	116	143
351	Jaylen Morris	SG	22	ATL	6	0	98	13	32	0406	2	10	0200	11	22	0500	0438	0	0	0	2	14	16	7	2	1	6	2	28
352	Marcus Morris	PF	28	BOS	54	21	1442	262	611	0429	86	234	0368	176	377	0467	0499	124	154	0805	43	246	289	72	35	12	65	100	734
353	Markieff Morris	PF	28	WAS	73	73	1968	330	687	0480	76	207	0367	254	480	0529	0536	105	128	0820	75	334	409	142	56	38	127	216	841
354	Monte Morris	PG	22	DEN	3	0	25	4	6	0667	0	1	0000	4	5	0800	0667	2	2	10000	0	2	2	7	3	0	1	1	10
355	Johnathan Motley	PF	22	DAL	11	4	176	40	75	0533	1	6	0167	39	69	0565	0540	15	28	0536	14	35	49	7	3	2	9	18	96
356	Timofey Mozgov	C	31	BRK	31	13	359	52	93	0559	4	18	0222	48	75	0640	0581	23	30	0767	32	66	98	11	5	13	33	39	131
357	Emmanuel Mudiay	PG	21	TOT	64	14	1245	204	526	0388	47	148	0318	157	378	0415	0433	98	129	0760	26	126	152	206	41	11	113	80	553
357	Emmanuel Mudiay	PG	21	DEN	42	0	752	129	322	0401	38	102	0373	91	220	0414	0460	63	78	0808	16	78	94	121	21	4	72	47	359
357	Emmanuel Mudiay	PG	21	NYK	22	14	493	75	204	0368	9	46	0196	66	158	0418	0390	35	51	0686	10	48	58	85	20	7	41	33	194
358	Shabazz Muhammad	SF-SG	25	TOT	43	2	418	84	188	0447	7	27	0259	77	161	0478	0465	39	50	0780	23	53	76	14	9	3	6	30	214
358	Shabazz Muhammad	SF	25	MIN	32	2	301	47	121	0388	4	19	0211	43	102	0422	0405	22	31	0710	15	30	45	7	5	2	5	23	120
358	Shabazz Muhammad	SG	25	MIL	11	0	117	37	67	0552	3	8	0375	34	59	0576	0575	17	19	0895	8	23	31	7	4	1	1	7	94
359	Xavier Munford	SG	25	MIL	6	0	21	1	6	0167	0	2	0000	1	4	0250	0167	1	2	0500	1	0	1	4	1	0	2	4	3
360	Dejounte Murray	PG	21	SAS	81	48	1743	270	609	0443	9	34	0265	261	575	0454	0451	105	148	0709	110	349	459	231	97	31	134	151	654
361	Jamal Murray	PG	20	DEN	81	80	2565	479	1062	0451	165	436	0378	314	626	0502	0529	229	253	0905	82	215	297	274	79	28	172	173	1352
362	Mike Muscala	C	26	ATL	53	7	1060	143	312	0458	62	167	0371	81	145	0559	0558	57	62	0919	56	174	230	51	31	27	42	80	405
363	Abdel Nader	SF	24	BOS	48	1	522	50	149	0336	23	65	0354	27	84	0321	0413	23	39	0590	13	58	71	26	15	10	34	45	146
364	Larry Nance Jr0	C	25	TOT	66	27	1421	240	413	0581	2	12	0167	238	401	0594	0584	91	137	0664	161	291	452	82	88	38	51	172	573
364	Larry Nance Jr0	C	25	LAL	42	17	922	152	253	0601	1	4	0250	151	249	0606	0603	55	87	0632	108	176	284	57	59	20	41	113	360
364	Larry Nance Jr0	C	25	CLE	24	10	499	88	160	0550	1	8	0125	87	152	0572	0553	36	50	0720	53	115	168	25	29	18	10	59	213
365	Shabazz Napier	PG	26	POR	74	10	1535	223	531	0420	82	218	0376	141	313	0450	0497	116	138	0841	26	144	170	150	81	14	90	84	644
366	Jameer Nelson	PG	35	TOT	50	0	1013	95	244	0389	41	124	0331	54	120	0450	0473	16	20	0800	13	91	104	179	27	4	67	81	247
366	Jameer Nelson	PG	35	NOP	43	0	897	84	205	0410	40	110	0364	44	95	0463	0507	13	17	0765	11	85	96	156	23	3	56	67	221
366	Jameer Nelson	PG	35	DET	7	0	116	11	39	0282	1	14	0071	10	25	0400	0295	3	3	10000	2	6	8	23	4	1	11	14	26
367	Raul Neto	PG	25	UTA	41	0	498	69	151	0457	19	47	0404	50	104	0481	0520	26	35	0743	7	42	49	75	13	4	36	38	183
368	Georges Niang	PF	24	UTA	9	0	32	4	11	0364	0	4	0000	4	7	0571	0364	1	2	0500	3	6	9	3	2	0	3	1	9
369	Joakim Noah	C	32	NYK	7	0	40	5	10	0500	0	0	0	5	10	0500	0500	2	4	0500	6	8	14	4	2	2	4	5	12
370	Nerlens Noel	C	23	DAL	30	6	472	55	105	0524	0	1	0000	55	104	0529	0524	21	28	0750	48	120	168	20	31	22	26	59	131
371	Lucas Nogueira	C	25	TOR	49	3	418	49	80	0613	5	19	0263	44	61	0721	0644	19	28	0679	18	69	87	22	23	43	16	49	122
372	Dirk Nowitzki	C	39	DAL	77	77	1900	346	758	0456	138	337	0409	208	421	0494	0547	97	108	0898	22	416	438	120	43	45	51	146	927
373	Frank Ntilikina	PG	19	NYK	78	9	1706	182	500	0364	50	157	0318	132	343	0385	0414	49	68	0721	37	140	177	250	65	18	131	181	463
374	Jusuf Nurkić	C	23	POR	79	79	2088	480	951	0505	0	7	0000	480	944	0508	0505	172	273	0630	189	519	708	143	64	111	183	247	1132
375	David Nwaba	SG	25	CHI	70	21	1646	202	423	0478	18	52	0346	184	371	0496	0499	133	203	0655	89	237	326	104	59	29	77	158	555
376	Johnny O'Bryant	PF	24	CHO	36	0	379	68	171	0398	14	43	0326	54	128	0422	0439	21	25	0840	29	64	93	14	9	6	15	45	171
377	Royce O'Neale	SF	24	UTA	69	4	1150	120	284	0423	42	118	0356	78	166	0470	0496	61	76	0803	25	211	236	95	36	16	55	105	343
378	Kyle O'Quinn	C	27	NYK	77	10	1387	224	384	0583	4	17	0235	220	367	0599	0589	98	127	0772	121	349	470	158	36	98	100	192	550
379	Semi Ojeleye	PF	23	BOS	73	0	1150	65	188	0346	40	125	0320	25	63	0397	0452	25	41	0610	37	124	161	20	21	4	25	91	195
380	Emeka Okafor	C	35	NOP	26	19	353	48	95	0505	0	0	0	48	95	0505	0505	18	22	0818	47	73	120	8	8	25	13	30	114
381	Jahlil Okafor	C	22	TOT	28	0	353	77	138	0558	1	4	0250	76	134	0567	0562	21	29	0724	21	64	85	12	3	18	21	51	176
381	Jahlil Okafor	C	22	PHI	2	0	25	4	9	0444	0	0	0	4	9	0444	0444	2	4	0500	4	5	9	1	0	2	3	7	10
381	Jahlil Okafor	C	22	BRK	26	0	328	73	129	0566	1	4	0250	72	125	0576	0570	19	25	0760	17	59	76	11	3	16	18	44	166
382	Victor Oladipo	SG	25	IND	75	75	2552	640	1342	0477	161	434	0371	479	908	0528	0537	294	368	0799	47	343	390	323	177	57	219	175	1735
383	Kelly Olynyk	PF	26	MIA	76	22	1779	316	636	0497	106	280	0379	210	356	0590	0580	134	174	0770	89	342	431	207	62	35	147	222	872
384	Chinanu Onuaku	C	21	HOU	1	0	22	2	5	0400	0	0	0	2	5	0400	0400	0	0	0	1	3	4	1	0	0	3	4	4
385	Cedi Osman	SF	22	CLE	61	12	672	90	186	0484	32	87	0368	58	99	0586	0570	26	46	0565	19	101	120	41	22	3	32	78	238
386	Kelly Oubre Jr0	SF	22	WAS	81	11	2231	318	790	0403	126	369	0341	192	421	0456	0482	191	233	0820	59	304	363	98	80	35	90	234	953
387	Zaza Pachulia	C	33	GSW	69	57	972	149	264	0564	0	1	0000	149	263	0567	0564	75	93	0806	89	232	321	109	38	17	72	122	373
388	Marcus Paige	PG	24	CHO	5	0	28	4	14	0286	2	8	0250	2	6	0333	0357	2	2	10000	0	4	4	3	0	0	0	0	12
389	Georgios Papagiannis	C	20	TOT	17	0	122	18	42	0429	0	0	0	18	42	0429	0429	0	0	0	13	24	37	9	4	6	8	12	36
389	Georgios Papagiannis	C	20	SAC	16	0	118	17	41	0415	0	0	0	17	41	0415	0415	0	0	0	12	24	36	9	2	6	8	12	34
389	Georgios Papagiannis	C	20	POR	1	0	4	1	1	10000	0	0	0	1	1	10000	10000	0	0	0	1	0	1	0	2	0	0	0	2
390	Jabari Parker	PF	22	MIL	31	3	743	160	332	0482	31	81	0383	129	251	0514	0529	40	54	0741	42	109	151	59	25	10	45	50	391
391	Tony Parker	PG	35	SAS	55	21	1071	178	388	0459	10	37	0270	168	351	0479	0472	55	78	0705	7	88	95	195	28	1	68	52	421
392	Chandler Parsons	SF	29	MEM	36	8	691	108	234	0462	51	121	0421	57	113	0504	0571	17	27	0630	14	76	90	69	18	11	35	53	284
393	Patrick Patterson	PF	28	OKC	82	3	1270	106	266	0398	66	171	0386	40	95	0421	0523	40	46	0870	32	161	193	57	48	23	33	87	318
394	Justin Patton	C	20	MIN	1	0	4	1	2	0500	0	0	0	1	2	0500	0500	0	0	0	0	0	0	0	1	0	0	1	2
395	Brandon Paul	SG	26	SAS	64	2	576	55	127	0433	15	54	0278	40	73	0548	0492	22	43	0512	6	62	68	37	25	7	29	58	147
396	Chris Paul	PG	32	HOU	58	58	1847	367	798	0460	144	379	0380	223	419	0532	0550	203	221	0919	37	276	313	457	96	14	128	141	1081
397	Adreian Payne	PF	26	ORL	5	0	43	7	10	0700	2	3	0667	5	7	0714	0800	5	6	0833	2	7	9	0	2	0	2	6	21
398	Cameron Payne	PG	23	CHI	25	14	582	87	215	0405	35	91	0385	52	124	0419	0486	12	16	0750	18	51	69	113	26	9	36	44	221
399	Elfrid Payton	PG	23	TOT	63	63	1808	329	667	0493	30	92	0326	299	575	0520	0516	109	168	0649	64	210	274	393	83	22	168	147	797
399	Elfrid Payton	PG	23	ORL	44	44	1257	238	458	0520	25	67	0373	213	391	0545	0547	72	114	0632	47	127	174	275	64	16	114	97	573
399	Elfrid Payton	PG	23	PHO	19	19	551	91	209	0435	5	25	0200	86	184	0467	0447	37	54	0685	17	83	100	118	19	6	54	50	224
400	Gary Payton II	PG	25	TOT	23	6	221	30	74	0405	6	25	0240	24	49	0490	0446	3	9	0333	13	31	44	21	7	3	7	30	69
400	Gary Payton II	PG	25	MIL	12	6	106	13	33	0394	2	12	0167	11	21	0524	0424	2	3	0667	4	13	17	9	3	1	3	17	30
400	Gary Payton II	PG	25	LAL	11	0	115	17	41	0415	4	13	0308	13	28	0464	0463	1	6	0167	9	18	27	12	4	2	4	13	39
401	Kendrick Perkins	C	33	CLE	1	0	15	1	2	0500	0	0	0	1	2	0500	0500	1	2	0500	0	1	1	2	1	0	1	1	3
402	London Perrantes	PG	23	CLE	14	0	66	2	13	0154	0	3	0000	2	10	0200	0154	3	5	0600	1	3	4	5	2	1	1	6	7
403	Alec Peters	PF	22	PHO	20	0	225	28	74	0378	18	58	0310	10	16	0625	0500	8	10	0800	8	29	37	12	2	2	4	13	82
404	Marshall Plumlee	C	25	MIL	8	0	52	1	3	0333	0	0	0	1	3	0333	0333	12	16	0750	4	13	17	2	0	1	3	10	14
405	Mason Plumlee	C	27	DEN	74	26	1439	221	368	0601	0	1	0000	221	367	0602	0601	82	179	0458	132	268	400	142	49	81	103	184	524
406	Miles Plumlee	C	29	ATL	55	35	918	105	180	0583	0	0	0	105	180	0583	0583	27	60	0450	77	151	228	45	17	30	63	79	237
407	Jakob Poeltl	C	22	TOR	82	0	1524	253	384	0659	1	2	0500	252	382	0660	0660	60	101	0594	165	228	393	57	39	100	85	212	567
408	Quincy Pondexter	SF	29	CHI	23	1	196	14	49	0286	3	22	0136	11	27	0407	0316	14	17	0824	8	19	27	9	8	2	11	24	45
409	Otto Porter Jr0	SF	24	WAS	77	77	2432	445	885	0503	138	313	0441	307	572	0537	0581	106	128	0828	103	389	492	157	116	41	75	151	1134
410	Bobby Portis	PF	22	CHI	73	4	1643	382	811	0471	80	223	0359	302	588	0514	0520	120	156	0769	159	339	498	123	50	23	103	130	964
411	Kristaps Porziņģis	PF	22	NYK	48	48	1553	390	889	0439	90	228	0395	300	661	0454	0489	218	275	0793	62	254	316	57	36	115	93	141	1088
412	Dwight Powell	C	26	DAL	79	25	1672	255	430	0593	28	84	0333	227	346	0656	0626	133	185	0719	135	309	444	91	67	32	59	186	671
413	Norman Powell	SG	24	TOR	70	18	1062	150	374	0401	53	186	0285	97	188	0516	0472	32	39	0821	14	105	119	89	37	16	66	111	385
414	Alex Poythress	PF	24	IND	25	0	104	11	26	0423	4	11	0364	7	15	0467	0500	0	0	0	7	10	17	2	3	1	2	16	26
415	Taurean Prince	SF	23	ATL	82	82	2464	415	975	0426	176	457	0385	239	518	0461	0516	152	180	0844	50	339	389	214	85	42	191	168	1158
416	Jacob Pullen	PG	28	PHI	3	0	6	1	2	0500	0	1	0000	1	1	10000	0500	0	0	0	0	0	0	0	0	0	1	0	2
417	Rodney Purvis	SG	23	ORL	16	2	290	35	107	0327	13	52	0250	22	55	0400	0388	13	15	0867	1	26	27	17	3	3	10	26	96
418	Zhou Qi	C	22	HOU	18	0	124	6	32	0188	2	19	0105	4	13	0308	0219	8	12	0667	6	16	22	2	2	14	10	14	22
419	Tim Quarterman	SG	23	HOU	3	0	13	1	3	0333	0	2	0000	1	1	10000	0333	2	2	10000	0	3	3	1	0	0	2	1	4
420	Ivan Rabb	PF	20	MEM	36	5	516	86	152	0566	0	0	0	86	152	0566	0566	29	36	0806	53	105	158	32	12	13	35	55	201
421	Julius Randle	C	23	LAL	82	49	2190	504	904	0558	10	45	0222	494	859	0575	0563	305	425	0718	181	473	654	210	43	45	213	274	1323
422	Zach Randolph	PF	36	SAC	59	57	1508	361	763	0473	51	147	0347	310	616	0503	0507	84	107	0785	97	300	397	127	42	10	116	119	857
423	Xavier Rathan-Mayes	SG	23	MEM	5	0	118	12	42	0286	1	14	0071	11	28	0393	0298	4	9	0444	0	5	5	18	6	3	11	18	29
424	J0J0 Redick	SG	33	PHI	70	70	2116	404	879	0460	193	460	0420	211	419	0504	0569	197	218	0904	9	169	178	210	35	6	103	123	1198
425	Davon Reed	SG	22	PHO	21	1	242	22	76	0289	11	38	0289	11	38	0289	0362	8	12	0667	2	37	39	13	10	2	10	17	63
426	Willie Reed	C	27	TOT	42	5	428	81	121	0669	1	2	0500	80	119	0672	0674	32	55	0582	35	86	121	10	9	22	19	56	195
426	Willie Reed	C	27	LAC	39	5	419	80	120	0667	1	2	0500	79	118	0669	0671	32	55	0582	35	85	120	9	9	22	19	53	193
426	Willie Reed	C	27	DET	3	0	9	1	1	10000	0	0	0	1	1	10000	10000	0	0	0	0	1	1	1	0	0	0	3	2
427	Josh Richardson	SF	24	MIA	81	81	2689	399	885	0451	127	336	0378	272	549	0495	0523	120	142	0845	69	216	285	231	121	75	140	199	1045
428	Malachi Richardson	SG	22	TOT	26	4	324	30	90	0333	12	40	0300	18	50	0360	0400	17	22	0773	5	29	34	13	10	1	10	27	89
428	Malachi Richardson	SG	22	SAC	25	4	319	29	88	0330	12	39	0308	17	49	0347	0398	17	22	0773	5	28	33	13	10	1	10	27	87
428	Malachi Richardson	SG	22	TOR	1	0	5	1	2	0500	0	1	0000	1	1	10000	0500	0	0	0	0	1	1	0	0	0	0	0	2
429	Austin Rivers	SG	25	LAC	61	59	2057	341	805	0424	136	360	0378	205	445	0461	0508	102	159	0642	27	118	145	242	74	16	109	152	920
430	Andre Roberson	SG	26	OKC	39	39	1037	87	162	0537	8	36	0222	79	126	0627	0562	12	38	0316	75	110	185	46	45	35	30	89	194
431	Devin Robinson	SF	22	WAS	1	0	13	1	3	0333	0	0	0	1	3	0333	0333	0	0	0	2	3	5	0	1	0	0	2	2
432	Glenn Robinson III	SF	24	IND	23	1	338	36	85	0424	14	34	0412	22	51	0431	0506	9	11	0818	11	26	37	17	13	1	5	14	95
433	Rajon Rondo	PG	31	NOP	65	63	1705	231	494	0468	50	150	0333	181	344	0526	0518	25	46	0543	31	232	263	533	70	10	151	119	537
434	Derrick Rose	PG	29	TOT	25	7	420	81	186	0435	7	30	0233	74	156	0474	0454	40	46	0870	13	22	35	37	7	4	35	16	209
434	Derrick Rose	PG	29	CLE	16	7	308	58	132	0439	6	24	0250	52	108	0481	0462	35	41	0854	10	19	29	26	3	4	28	14	157
434	Derrick Rose	PG	29	MIN	9	0	112	23	54	0426	1	6	0167	22	48	0458	0435	5	5	10000	3	3	6	11	4	0	7	2	52
435	Terrence Ross	SG	26	ORL	24	20	600	76	191	0398	30	93	0323	46	98	0469	0476	27	36	0750	10	63	73	38	27	11	29	45	209
436	Terry Rozier	PG	23	BOS	80	16	2068	316	800	0395	153	402	0381	163	398	0410	0491	115	149	0772	63	313	376	232	80	19	80	123	900
437	Ricky Rubio	PG	27	UTA	77	77	2254	346	827	0418	96	273	0352	250	554	0451	0476	220	254	0866	44	307	351	410	121	11	207	206	1008
438	D'Angelo Russell	PG	21	BRK	48	35	1234	278	672	0414	90	278	0324	188	394	0477	0481	97	131	0740	30	159	189	249	36	17	147	93	743
439	Domantas Sabonis	C	21	IND	74	19	1810	340	661	0514	13	37	0351	327	624	0524	0524	168	224	0750	165	407	572	151	40	32	137	220	861
440	JaKarr Sampson	SF	24	SAC	22	6	344	44	81	0543	5	10	0500	39	71	0549	0574	10	16	0625	21	57	78	9	8	22	8	48	103
441	Dario Šarić	PF	23	PHI	78	73	2310	403	890	0453	157	399	0393	246	491	0501	0541	178	207	0860	154	366	520	202	51	20	148	160	1141
442	Tomáš Satoranský	SG	26	WAS	73	30	1643	201	384	0523	47	101	0465	154	283	0544	0585	75	96	0781	72	161	233	286	52	15	83	131	524
443	Dennis Schröder	PG	24	ATL	67	67	2078	500	1146	0436	76	262	0290	424	884	0480	0469	225	265	0849	44	164	208	417	72	6	183	147	1301
444	Mike Scott	PF	29	WAS	76	1	1406	276	524	0527	66	163	0405	210	361	0582	0590	50	76	0658	50	197	247	80	23	10	79	148	668
445	Thabo Sefolosha	SF	33	UTA	38	6	806	118	240	0492	32	84	0381	86	156	0551	0558	44	54	0815	29	132	161	33	52	12	30	59	312
446	Wayne Selden	SG	23	MEM	35	9	692	116	269	0431	49	122	0402	67	147	0456	0522	44	59	0746	16	40	56	66	18	5	54	59	325
447	Ramon Sessions	PG	31	TOT	28	3	392	42	117	0359	8	26	0308	34	91	0374	0393	44	57	0772	6	32	38	77	14	2	30	29	136
447	Ramon Sessions	PG	31	NYK	13	3	167	17	53	0321	2	11	0182	15	42	0357	0340	12	15	0800	1	17	18	27	7	1	15	14	48
447	Ramon Sessions	PG	31	WAS	15	0	225	25	64	0391	6	15	0400	19	49	0388	0438	32	42	0762	5	15	20	50	7	1	15	15	88
448	Iman Shumpert	SG	27	CLE	14	6	276	22	58	0379	7	26	0269	15	32	0469	0440	11	15	0733	7	34	41	17	9	4	16	22	62
449	Pascal Siakam	PF	23	TOR	81	5	1679	253	498	0508	29	132	0220	224	366	0612	0537	54	87	0621	79	285	364	159	62	42	67	166	589
450	Xavier Silas	SG	30	BOS	2	0	7	0	3	0000	0	2	0000	0	1	0000	0000	0	0	0	1	1	2	0	1	0	0	1	0
451	Ben Simmons	PG	21	PHI	81	81	2732	544	998	0545	0	11	0000	544	987	0551	0545	191	341	0560	145	514	659	661	140	70	278	211	1279
452	Jonathon Simmons	SG	28	ORL	69	50	2029	354	761	0465	69	204	0338	285	557	0512	0511	185	241	0768	61	178	239	171	58	16	146	175	962
453	Kobi Simmons	PG	20	MEM	32	12	643	80	189	0423	11	39	0282	69	150	0460	0452	25	25	10000	14	36	50	68	18	5	44	61	196
454	Kyle Singler	SF	29	OKC	12	0	59	7	21	0333	2	5	0400	5	16	0313	0381	7	13	0538	1	9	10	2	1	0	3	4	23
455	Marcus Smart	SG	23	BOS	54	11	1614	189	515	0367	75	249	0301	114	266	0429	0440	97	133	0729	43	146	189	259	71	23	129	133	550
456	Dennis Smith Jr0	PG	20	DAL	69	69	2049	404	1024	0395	106	339	0313	298	685	0435	0446	134	193	0694	50	210	260	358	71	18	194	152	1048
457	Ish Smith	PG	29	DET	82	35	2043	389	801	0486	35	101	0347	354	700	0506	0507	81	116	0698	27	197	224	360	64	20	108	140	894
458	J0R0 Smith	SG	32	CLE	80	61	2244	240	595	0403	143	381	0375	97	214	0453	0524	39	56	0696	29	206	235	141	68	11	81	161	662
459	Jason Smith	C	31	WAS	33	2	285	45	115	0391	4	32	0125	41	83	0494	0409	19	21	0905	18	35	53	14	3	13	16	44	113
460	Josh Smith	PF	32	NOP	3	0	12	1	4	0250	0	0	0	1	4	0250	0250	0	0	0	3	1	4	0	0	0	0	3	2
461	Tony Snell	SG	26	MIL	75	59	2053	185	425	0435	108	268	0403	77	157	0490	0562	38	48	0792	9	132	141	98	47	28	36	115	516
462	Marreese Speights	C	30	ORL	52	3	675	138	349	0395	86	233	0369	52	116	0448	0519	40	55	0727	21	112	133	40	8	22	40	106	402
463	Nik Stauskas	SG	24	TOT	41	0	523	60	154	0390	40	100	0400	20	54	0370	0519	21	29	0724	4	60	64	39	9	4	26	24	181
463	Nik Stauskas	SG	24	PHI	6	0	45	1	4	0250	0	1	0000	1	3	0333	0250	2	2	10000	0	1	1	1	4	0	4	3	4
463	Nik Stauskas	SG	24	BRK	35	0	478	59	150	0393	40	99	0404	19	51	0373	0527	19	27	0704	4	59	63	38	5	4	22	21	177
464	Lance Stephenson	SG	27	IND	82	7	1850	303	709	0427	67	232	0289	236	477	0495	0475	84	127	0661	62	362	424	235	46	17	131	177	757
465	David Stockton	PG	26	UTA	3	0	9	2	3	0667	2	3	0667	0	0	0	10000	4	4	10000	0	0	0	0	0	0	1	3	10
466	Julyan Stone	SG	29	CHO	23	0	175	6	13	0462	6	13	0462	0	0	0	0692	1	2	0500	1	28	29	26	4	2	7	21	19
467	Edmond Sumner	PG	22	IND	1	0	2	1	1	10000	0	0	0	1	1	10000	10000	0	0	0	0	1	1	0	0	0	0	1	2
468	Caleb Swanigan	PF	20	POR	27	3	189	24	60	0400	1	8	0125	23	52	0442	0408	12	18	0667	15	39	54	14	5	3	18	37	61
469	Jayson Tatum	SF	19	BOS	80	80	2443	397	835	0475	105	242	0434	292	593	0492	0538	213	258	0826	50	352	402	128	83	58	114	170	1112
470	Isaiah Taylor	PG	23	ATL	67	9	1167	163	390	0418	20	80	0250	143	310	0461	0444	99	141	0702	22	72	94	206	34	10	84	116	445
471	Jeff Teague	PG	29	MIN	70	70	2311	354	794	0446	84	228	0368	270	566	0477	0499	202	239	0845	24	185	209	492	102	23	177	171	994
472	Marquis Teague	PG	24	MEM	3	0	74	4	16	0250	1	4	0250	3	12	0250	0281	2	5	0400	1	5	6	13	4	0	3	5	11
473	Mirza Teletović	PF	32	MIL	10	0	159	25	57	0439	21	45	0467	4	12	0333	0623	0	0	0	3	20	23	10	4	1	7	14	71
474	Garrett Temple	SG	31	SAC	65	35	1615	199	476	0418	89	227	0392	110	249	0442	0512	60	78	0769	22	130	152	124	57	27	79	135	547
475	Miloš Teodosić	PG	30	LAC	45	36	1134	151	360	0419	88	232	0379	63	128	0492	0542	39	46	0848	16	110	126	209	23	5	97	103	429
476	Jason Terry	SG	40	MIL	51	4	814	59	154	0383	40	115	0348	19	39	0487	0513	8	9	0889	5	43	48	59	42	13	25	52	166
477	Daniel Theis	C	25	BOS	63	3	936	126	233	0541	18	58	0310	108	175	0617	0579	61	81	0753	90	184	274	56	30	48	56	157	331
478	Isaiah Thomas	PG	28	TOT	32	15	862	157	421	0373	55	188	0293	102	233	0438	0438	117	131	0893	17	50	67	153	15	3	95	58	486
478	Isaiah Thomas	PG	28	CLE	15	14	406	70	194	0361	22	87	0253	48	107	0449	0418	59	68	0868	7	24	31	68	9	2	41	25	221
478	Isaiah Thomas	PG	28	LAL	17	1	456	87	227	0383	33	101	0327	54	126	0429	0456	58	63	0921	10	26	36	85	6	1	54	33	265
479	Lance Thomas	PF	29	NYK	73	31	1353	102	267	0382	50	124	0403	52	143	0364	0476	44	53	0830	44	131	175	44	30	14	40	134	298
480	Klay Thompson	SG	27	GSW	73	73	2506	575	1179	0488	229	521	0440	346	658	0526	0585	82	98	0837	31	246	277	185	55	34	128	117	1461
481	Tristan Thompson	C	26	CLE	53	22	1072	132	235	0562	0	0	0	132	235	0562	0562	43	79	0544	126	226	352	33	16	17	36	102	307
482	Sindarius Thornwell	SG	23	LAC	73	17	1156	100	233	0429	23	61	0377	77	172	0448	0479	59	88	0670	33	107	140	68	48	25	53	125	282
483	Anthony Tolliver	PF	32	DET	79	14	1757	219	472	0464	159	365	0436	60	107	0561	0632	106	133	0797	50	191	241	90	32	21	58	144	703
484	Karl-Anthony Towns	C	22	MIN	82	82	2918	639	1172	0545	120	285	0421	519	887	0585	0596	345	402	0858	238	774	1012	199	64	115	159	285	1743
485	P0J0 Tucker	PF	32	HOU	82	34	2281	172	441	0390	115	310	0371	57	131	0435	0520	43	60	0717	93	364	457	77	78	26	74	205	502
486	Evan Turner	SF	29	POR	79	40	2034	258	577	0447	42	132	0318	216	445	0485	0484	91	107	0850	30	214	244	173	47	29	99	163	649
487	Myles Turner	C	21	IND	65	62	1836	306	639	0479	56	157	0357	250	482	0519	0523	160	206	0777	93	324	417	87	38	118	96	186	828
488	Ekpe Udoh	C	30	UTA	63	3	810	60	120	0500	0	1	0000	60	119	0504	0500	42	56	0750	68	82	150	53	43	74	20	105	162
489	Tyler Ulis	PG	22	PHO	71	43	1658	214	551	0388	42	146	0288	172	405	0425	0426	84	101	0832	24	104	128	311	70	7	127	120	554
490	Jonas Valančiūnas	C	25	TOR	77	77	1727	390	687	0568	30	74	0405	360	613	0587	0590	170	211	0806	183	477	660	81	29	69	115	192	980
491	Denzel Valentine	SG	24	CHI	77	37	2095	301	721	0417	143	370	0386	158	351	0450	0517	38	51	0745	48	345	393	244	65	11	99	185	783
492	Fred VanVleet	PG	23	TOR	76	0	1520	232	545	0426	108	261	0414	124	284	0437	0525	84	101	0832	25	159	184	243	68	19	74	130	656
493	Rashad Vaughn	SG	21	TOT	28	0	212	23	56	0411	14	37	0378	9	19	0474	0536	4	6	0667	3	18	21	13	5	3	6	15	64
493	Rashad Vaughn	SG	21	MIL	22	0	173	21	50	0420	13	35	0371	8	15	0533	0550	4	6	0667	2	15	17	12	4	3	4	12	59
493	Rashad Vaughn	SG	21	BRK	1	0	4	0	0	0	0	0	0	0	0	0	0	0	0	0	0	0	0	1	0	0	0	1	0
493	Rashad Vaughn	SG	21	ORL	5	0	35	2	6	0333	1	2	0500	1	4	0250	0417	0	0	0	1	3	4	0	1	0	2	2	5
494	Noah Vonleh	PF	22	TOT	54	16	875	104	234	0444	20	66	0303	84	168	0500	0487	36	58	0621	70	241	311	34	19	17	31	68	264
494	Noah Vonleh	PF	22	POR	33	12	476	47	96	0490	2	6	0333	45	90	0500	0500	23	31	0742	35	132	167	13	6	11	15	42	119
494	Noah Vonleh	PF	22	CHI	21	4	399	57	138	0413	18	60	0300	39	78	0500	0478	13	27	0481	35	109	144	21	13	6	16	26	145
495	Nikola Vučević	C	27	ORL	57	57	1683	399	840	0475	64	204	0314	335	636	0527	0513	77	94	0819	101	422	523	191	56	62	109	144	939
496	Dwyane Wade	SG	36	TOT	67	3	1536	299	682	0438	32	111	0288	267	571	0468	0462	135	189	0714	50	202	252	228	61	47	140	124	765
496	Dwyane Wade	SG	36	CLE	46	3	1069	198	435	0455	23	70	0329	175	365	0479	0482	94	134	0701	39	142	181	163	42	32	92	84	513
496	Dwyane Wade	SG	36	MIA	21	0	467	101	247	0409	9	41	0220	92	206	0447	0427	41	55	0745	11	60	71	65	19	15	48	40	252
497	Dion Waiters	SG	26	MIA	30	30	918	163	410	0398	52	170	0306	111	240	0463	0461	51	69	0739	8	69	77	113	23	9	70	61	429
498	Kemba Walker	PG	27	CHO	80	80	2736	588	1363	0431	231	601	0384	357	762	0469	0516	363	420	0864	32	216	248	444	91	24	179	98	1770
499	John Wall	PG	27	WAS	41	41	1410	280	667	0420	62	167	0371	218	500	0436	0466	175	241	0726	22	128	150	393	57	45	158	80	797
500	Tyrone Wallace	PG	23	LAC	30	19	851	110	247	0445	10	40	0250	100	207	0483	0466	61	78	0782	21	84	105	71	27	13	46	83	291
501	Derrick Walton	PG	22	MIA	16	0	147	8	25	0320	7	17	0412	1	8	0125	0460	6	6	10000	2	14	16	16	7	3	2	7	29
502	Jameel Warney	PF	24	DAL	3	0	27	7	12	0583	0	0	0	7	12	0583	0583	3	5	0600	4	5	9	0	0	0	1	2	17
503	T0J0 Warren	SF	24	PHO	65	65	2142	529	1063	0498	20	90	0222	509	973	0523	0507	193	255	0757	125	208	333	85	65	41	85	149	1271
504	Travis Wear	SF	27	LAL	17	0	228	25	72	0347	17	47	0362	8	25	0320	0465	8	8	10000	0	38	38	7	4	5	6	30	75
505	James Webb III	SF	24	BRK	10	0	120	6	24	0250	4	19	0211	2	5	0400	0333	0	0	0	8	16	24	4	1	0	4	10	16
506	Briante Weber	PG	25	TOT	18	0	237	19	43	0442	4	11	0364	15	32	0469	0488	8	10	0800	8	27	35	22	18	5	15	28	50
506	Briante Weber	PG	25	HOU	13	0	118	9	22	0409	4	9	0444	5	13	0385	0500	4	4	10000	3	15	18	13	10	3	7	18	26
506	Briante Weber	PG	25	MEM	5	0	119	10	21	0476	0	2	0000	10	19	0526	0476	4	6	0667	5	12	17	9	8	2	8	10	24
507	David West	C	37	GSW	73	0	999	216	378	0571	3	8	0375	213	370	0576	0575	60	79	0759	64	174	238	138	47	75	80	120	495
508	Russell Westbrook	PG	29	OKC	80	80	2914	757	1687	0449	97	326	0298	660	1361	0485	0477	417	566	0737	152	652	804	820	147	20	381	200	2028
509	Andrew White	SF	24	ATL	15	0	209	25	73	0342	18	49	0367	7	24	0292	0466	1	4	0250	4	30	34	6	3	1	8	12	69
510	Derrick White	PG	23	SAS	17	0	139	16	33	0485	8	13	0615	8	20	0400	0606	14	20	0700	5	21	26	9	4	3	6	8	54
511	Okaro White	PF	25	MIA	6	4	80	7	16	0438	4	11	0364	3	5	0600	0563	2	3	0667	3	8	11	2	1	1	1	6	20
512	Isaiah Whitehead	PG	22	BRK	16	0	180	40	86	0465	7	18	0389	33	68	0485	0506	13	19	0684	4	22	26	20	8	2	24	23	100
513	Hassan Whiteside	C	28	MIA	54	54	1364	312	578	0540	2	2	10000	310	576	0538	0542	128	182	0703	174	444	618	54	37	94	92	131	754
514	Andrew Wiggins	SF	22	MIN	82	82	2979	569	1300	0438	112	338	0331	457	962	0475	0481	202	314	0643	82	276	358	160	91	51	138	163	1452
515	Jacob Wiley	PF	23	BRK	5	0	33	1	4	0250	1	2	0500	0	2	0000	0375	1	2	0500	2	9	11	2	1	0	0	4	4
516	Damien Wilkins	SF	38	IND	19	1	152	13	39	0333	4	18	0222	9	21	0429	0385	3	4	0750	5	11	16	9	2	1	5	7	33
517	Alan Williams	PF	25	PHO	5	0	70	7	18	0389	0	0	0	7	18	0389	0389	6	9	0667	3	19	22	8	5	1	7	13	20
518	C0J0 Williams	SG	27	LAC	38	17	707	87	197	0442	22	78	0282	65	119	0546	0497	13	16	0813	12	44	56	43	31	13	20	63	209
519	Derrick Williams	PF	26	LAL	2	0	9	1	4	0250	0	2	0000	1	2	0500	0250	0	0	0	0	1	1	0	0	0	0	0	2
520	Lou Williams	SG	31	LAC	79	19	2589	582	1337	0435	186	518	0359	396	819	0484	0505	432	491	0880	40	158	198	417	85	19	234	106	1782
521	Marvin Williams	PF	31	CHO	78	78	2006	258	563	0458	126	305	0413	132	258	0512	0570	102	123	0829	74	296	370	96	56	38	66	116	744
522	Matt Williams	SG	24	MIA	3	0	11	2	6	0333	1	5	0200	1	1	10000	0417	0	0	0	0	1	1	0	0	0	1	1	5
523	Troy Williams	SF	23	TOT	21	1	307	51	109	0468	11	38	0289	40	71	0563	0518	20	30	0667	22	41	63	16	20	4	19	34	133
523	Troy Williams	SF	23	HOU	4	0	17	2	9	0222	0	5	0000	2	4	0500	0222	1	3	0333	1	3	4	1	1	0	1	2	5
523	Troy Williams	SF	23	NYK	17	1	290	49	100	0490	11	33	0333	38	67	0567	0545	19	27	0704	21	38	59	15	19	4	18	32	128
524	D0J0 Wilson	PF	21	MIL	22	0	71	9	16	0563	2	5	0400	7	11	0636	0625	1	2	0500	2	8	10	3	3	1	4	7	21
525	Jamil Wilson	SF	27	LAC	15	10	274	38	81	0469	27	63	0429	11	18	0611	0636	2	4	0500	3	29	32	10	5	8	8	34	105
526	Justise Winslow	PF	21	MIA	68	25	1680	207	488	0424	49	129	0380	158	359	0440	0474	66	104	0635	64	306	370	148	54	33	77	140	529
527	Jeff Withey	C	27	DAL	9	0	39	6	16	0375	2	10	0200	4	6	0667	0438	1	2	0500	1	9	10	0	0	3	2	3	15
528	Nate Wolters	PG	26	UTA	5	0	19	1	6	0167	0	0	0	1	6	0167	0167	0	0	0	1	1	2	1	0	0	0	1	2
529	Brandan Wright	PF	30	TOT	28	1	381	59	102	0578	0	0	0	59	102	0578	0578	21	33	0636	33	62	95	13	13	26	8	32	139
529	Brandan Wright	PF	30	MEM	27	1	366	57	99	0576	0	0	0	57	99	0576	0576	21	33	0636	32	61	93	13	13	25	8	29	135
529	Brandan Wright	PF	30	HOU	1	0	15	2	3	0667	0	0	0	2	3	0667	0667	0	0	0	1	1	2	0	0	1	0	3	4
530	Delon Wright	PG	25	TOR	69	4	1433	201	432	0465	56	153	0366	145	279	0520	0530	97	117	0829	45	153	198	200	72	33	78	81	555
531	Guerschon Yabusele	PF	22	BOS	33	4	235	26	61	0426	12	37	0324	14	24	0583	0525	15	22	0682	17	35	52	16	4	5	12	23	79
532	James Young	SG	22	PHI	6	0	61	5	14	0357	3	10	0300	2	4	0500	0464	4	6	0667	0	2	2	2	0	0	1	4	17
533	Joe Young	PG	25	IND	53	1	558	80	186	0430	25	66	0379	55	120	0458	0497	22	29	0759	12	51	63	39	14	1	26	39	207
534	Nick Young	SG	32	GSW	80	8	1393	201	488	0412	123	326	0377	78	162	0481	0538	56	65	0862	20	105	125	36	38	7	39	100	581
535	Thaddeus Young	PF	29	IND	81	81	2607	421	864	0487	58	181	0320	363	683	0531	0521	55	92	0598	184	328	512	152	135	36	105	175	955
536	Cody Zeller	C	25	CHO	33	0	627	85	156	0545	2	3	0667	83	153	0542	0551	61	85	0718	67	110	177	31	14	21	33	81	233
537	Tyler Zeller	C	28	TOT	66	34	1109	187	334	0560	10	28	0357	177	306	0578	0575	57	79	0722	110	195	305	47	15	35	47	126	441
537	Tyler Zeller	C	28	BRK	42	33	703	125	229	0546	10	26	0385	115	203	0567	0568	40	60	0667	63	131	194	28	8	21	35	78	300
537	Tyler Zeller	C	28	MIL	24	1	406	62	105	0590	0	2	0000	62	103	0602	0590	17	19	0895	47	64	111	19	7	14	12	48	141
538	Paul Zipser	SF	23	CHI	54	12	824	81	234	0346	37	110	0336	44	124	0355	0425	19	25	0760	13	118	131	46	20	15	43	86	218
539	Ante Žižić	C	21	CLE	32	2	214	49	67	0731	0	0	0	49	67	0731	0731	21	29	0724	24	36	60	5	2	13	11	30	119
540	Ivica Zubac	C	20	LAL	43	0	410	61	122	0500	0	1	0000	61	121	0504	0500	39	51	0765	45	78	123	25	8	15	26	47	161
