Rk	Player	Pos	Age	Tm	G	GS	MP	FG	FGA	FG%	3P	3PA	3P%	2P	2PA	2P%	eFG%	FT	FTA	FT%	ORB	DRB	TRB	AST	STL	BLK	TOV	PF	PTS
1	Steven Adams	C	26	OKC	63	63	1680	283	478	0592	1	3	0333	282	475	0594	0593	117	201	0582	207	376	583	146	51	67	94	122	684
2	Bam Adebayo	PF	22	MIA	72	72	2417	440	790	0557	2	14	0143	438	776	0564	0558	264	382	0691	176	559	735	368	82	93	204	182	1146
3	LaMarcus Aldridge	C	34	SAS	53	53	1754	391	793	0493	61	157	0389	330	636	0519	0532	158	191	0827	103	289	392	129	36	87	74	128	1001
4	Kyle Alexander	C	23	MIA	2	0	13	1	2	0500	0	0	0	1	2	0500	0500	0	0	0	2	1	3	0	0	0	1	1	2
5	Nickeil Alexander-Walker	SG	21	NOP	47	1	591	98	266	0368	46	133	0346	52	133	0391	0455	25	37	0676	9	75	84	89	17	8	54	57	267
6	Grayson Allen	SG	24	MEM	38	0	718	117	251	0466	57	141	0404	60	110	0545	0580	39	45	0867	8	77	85	52	10	2	33	53	330
7	Jarrett Allen	C	21	BRK	70	64	1852	302	465	0649	0	6	0000	302	459	0658	0649	171	270	0633	216	455	671	110	40	92	77	162	775
8	Kadeem Allen	PG	27	NYK	10	0	117	19	44	0432	5	16	0313	14	28	0500	0489	7	11	0636	2	7	9	21	5	2	8	7	50
9	Al-Farouq Aminu	PF	29	ORL	18	2	380	25	86	0291	9	36	0250	16	50	0320	0343	19	29	0655	24	63	87	21	18	8	17	27	78
10	Justin Anderson	SG	26	BRK	10	1	107	10	38	0263	6	29	0207	4	9	0444	0342	2	4	0500	1	20	21	8	0	6	4	13	28
11	Kyle Anderson	SF	26	MEM	67	28	1330	157	331	0474	24	85	0282	133	246	0541	0511	52	78	0667	58	227	285	162	54	37	66	111	390
12	Ryan Anderson	C	31	HOU	2	0	14	2	7	0286	1	5	0200	1	2	0500	0357	0	0	0	0	7	7	2	1	0	1	1	5
13	Giannis Antetokounmpo	PF	25	MIL	63	63	1917	685	1238	0553	89	293	0304	596	945	0631	0589	398	629	0633	140	716	856	354	61	66	230	195	1857
14	Kostas Antetokounmpo	PF	22	LAL	5	0	20	3	3	10000	0	0	0	3	3	10000	10000	1	2	0500	2	1	3	2	0	0	1	2	7
15	Thanasis Antetokounmpo	SF	27	MIL	20	2	129	24	48	0500	0	10	0000	24	38	0632	0500	7	17	0412	12	12	24	15	7	2	12	18	55
16	Carmelo Anthony	PF	35	POR	58	58	1902	336	782	0430	87	226	0385	249	556	0448	0485	136	161	0845	71	297	368	85	49	27	100	171	895
17	OG Anunoby	SF	22	TOR	69	68	2066	286	566	0505	89	228	0390	197	338	0583	0584	72	102	0706	80	284	364	108	96	45	79	167	733
18	Ryan Arcidiacono	PG	25	CHI	58	4	930	90	220	0409	54	138	0391	36	82	0439	0532	27	38	0711	20	90	110	96	27	3	37	96	261
19	Trevor Ariza	SF	34	TOT	53	21	1493	142	324	0438	77	207	0372	65	117	0556	0557	62	74	0838	34	212	246	91	69	15	56	111	423
19	Trevor Ariza	SF	34	SAC	32	0	791	64	165	0388	43	122	0352	21	43	0488	0518	21	27	0778	21	125	146	50	35	7	28	63	192
19	Trevor Ariza	SF	34	POR	21	21	702	78	159	0491	34	85	0400	44	74	0595	0597	41	47	0872	13	87	100	41	34	8	28	48	231
20	D0J0 Augustin	PG	32	ORL	57	13	1420	184	461	0399	70	201	0348	114	260	0438	0475	161	181	0890	22	100	122	262	34	1	86	72	599
21	Deandre Ayton	C	21	PHO	38	32	1236	310	568	0546	3	13	0231	307	555	0553	0548	67	89	0753	147	289	436	72	26	58	80	117	690
22	Dwayne Bacon	SG	24	CHO	39	11	687	85	244	0348	19	67	0284	66	177	0373	0387	35	53	0660	15	85	100	52	23	2	37	52	224
23	Marvin Bagley III	C	20	SAC	13	6	334	78	167	0467	4	22	0182	74	145	0510	0479	25	31	0806	29	68	97	10	6	12	18	43	185
24	Lonzo Ball	PG	22	NOP	63	54	2025	277	687	0403	148	395	0375	129	292	0442	0511	43	76	0566	71	312	383	438	88	38	193	128	745
25	Mo Bamba	C	21	ORL	62	0	878	132	286	0462	37	107	0346	95	179	0531	0526	31	46	0674	100	202	302	42	23	86	42	116	332
26	J0J0 Barea	PG	35	DAL	29	6	450	85	207	0411	32	85	0376	53	122	0434	0488	20	22	0909	10	43	53	112	5	2	38	27	222
27	Harrison Barnes	PF	27	SAC	72	72	2482	365	793	0460	102	268	0381	263	525	0501	0525	214	267	0801	77	278	355	159	43	12	88	93	1046
28	RJ Barrett	SG	19	NYK	56	55	1704	292	727	0402	63	197	0320	229	530	0432	0445	156	254	0614	50	229	279	143	55	17	124	122	803
29	Will Barton	SF	29	DEN	58	58	1916	332	738	0450	108	288	0375	224	450	0498	0523	102	133	0767	76	289	365	212	61	29	88	121	874
30	Keita Bates-Diop	PF-SF	24	TOT	44	0	744	100	234	0427	34	103	0330	66	131	0504	0500	54	75	0720	25	102	127	30	19	24	17	43	288
30	Keita Bates-Diop	PF	24	MIN	37	0	646	87	206	0422	31	94	0330	56	112	0500	0498	46	65	0708	21	89	110	30	17	20	14	36	251
30	Keita Bates-Diop	SF	24	DEN	7	0	98	13	28	0464	3	9	0333	10	19	0526	0518	8	10	0800	4	13	17	0	2	4	3	7	37
31	Nicolas Batum	SF	31	CHO	22	3	505	28	81	0346	14	49	0286	14	32	0438	0432	9	10	0900	25	75	100	66	17	8	22	41	79
32	Aron Baynes	C	33	PHO	42	28	934	183	381	0480	59	168	0351	124	213	0582	0558	56	75	0747	71	166	237	67	10	23	50	141	481
33	Kent Bazemore	SF	30	TOT	68	21	1688	200	534	0375	84	244	0344	116	290	0400	0453	113	147	0769	27	267	294	93	74	40	91	196	597
33	Kent Bazemore	SF	30	POR	43	21	1111	113	326	0347	56	171	0327	57	155	0368	0433	58	72	0806	13	159	172	61	45	31	60	121	340
33	Kent Bazemore	SF	30	SAC	25	0	577	87	208	0418	28	73	0384	59	135	0437	0486	55	75	0733	14	108	122	32	29	9	31	75	257
34	Darius Bazley	PF	19	OKC	61	9	1130	125	317	0394	49	141	0348	76	176	0432	0472	43	62	0694	30	216	246	41	23	41	45	55	342
35	Bradley Beal	SG	26	WAS	57	57	2053	593	1303	0455	170	481	0353	423	822	0515	0520	385	457	0842	52	190	242	347	71	23	194	126	1741
36	Malik Beasley	SG	23	TOT	55	14	1209	227	534	0425	107	276	0388	120	258	0465	0525	54	66	0818	18	130	148	75	40	8	57	77	615
36	Malik Beasley	SG	23	DEN	41	0	746	117	301	0389	58	161	0360	59	140	0421	0485	33	38	0868	9	68	77	48	31	6	36	50	325
36	Malik Beasley	SG	23	MIN	14	14	463	110	233	0472	49	115	0426	61	118	0517	0577	21	28	0750	9	62	71	27	9	2	21	27	290
37	Marco Belinelli	SG	33	SAS	57	0	883	123	314	0392	67	178	0376	56	136	0412	0498	48	58	0828	7	92	99	69	12	1	19	45	361
38	Jordan Bell	C	25	TOT	29	0	256	35	67	0522	4	12	0333	31	55	0564	0552	19	31	0613	30	51	81	16	3	10	21	19	93
38	Jordan Bell	C	25	MIN	27	0	235	32	60	0533	2	9	0222	30	51	0588	0550	17	29	0586	28	50	78	14	2	10	18	17	83
38	Jordan Bell	C	25	MEM	2	0	21	3	7	0429	2	3	0667	1	4	0250	0571	2	2	10000	2	1	3	2	1	0	3	2	10
39	DeAndre' Bembry	SG	25	ATL	43	4	915	104	228	0456	15	65	0231	89	163	0546	0489	26	48	0542	34	118	152	81	55	19	60	84	249
40	Dragan Bender	PF-C	22	TOT	16	3	286	41	92	0446	15	43	0349	26	49	0531	0527	10	14	0714	16	57	73	28	4	9	21	42	107
40	Dragan Bender	C	22	MIL	7	0	91	10	21	0476	4	9	0444	6	12	0500	0571	2	3	0667	0	20	20	9	0	5	5	16	26
40	Dragan Bender	PF	22	GSW	9	3	195	31	71	0437	11	34	0324	20	37	0541	0514	8	11	0727	16	37	53	19	4	4	16	26	81
41	Dāvis Bertāns	PF	27	WAS	54	4	1583	265	610	0434	200	472	0424	65	138	0471	0598	104	122	0852	35	210	245	92	37	33	59	139	834
42	Patrick Beverley	PG	31	LAC	51	50	1342	147	341	0431	80	206	0388	67	135	0496	0548	31	47	0660	57	209	266	183	54	25	66	156	405
43	Khem Birch	C	27	ORL	48	24	922	73	143	0510	0	1	0000	73	142	0514	0510	66	101	0653	91	129	220	50	20	23	31	91	212
44	Goga Bitadze	C	20	IND	54	2	471	70	150	0467	8	42	0190	62	108	0574	0493	24	33	0727	25	81	106	23	10	37	28	65	172
45	Bismack Biyombo	C	27	CHO	53	29	1029	151	278	0543	0	0	0	151	278	0543	0543	91	151	0603	120	188	308	50	10	49	48	116	393
46	Nemanja Bjelica	PF	31	SAC	72	67	2011	314	653	0481	134	320	0419	180	333	0541	0583	69	84	0821	111	347	458	203	62	40	99	216	831
47	Eric Bledsoe	PG	30	MIL	61	61	1646	334	703	0475	74	215	0344	260	488	0533	0528	169	214	0790	43	239	282	328	57	26	148	128	911
48	Bogdan Bogdanović	SG	27	SAC	61	28	1766	337	766	0440	164	441	0372	173	325	0532	0547	86	116	0741	26	181	207	207	64	15	102	133	924
49	Bojan Bogdanović	SF	30	UTA	63	63	2083	418	935	0447	189	457	0414	229	478	0479	0548	250	277	0903	39	220	259	131	34	7	159	110	1275
50	Bol Bol	PF	20	DEN	7	0	87	14	28	0500	4	9	0444	10	19	0526	0571	8	10	0800	5	14	19	6	2	6	10	11	40
51	Jonah Bolden	C	24	TOT	7	0	47	4	11	0364	0	4	0000	4	7	0571	0364	2	4	0500	3	6	9	0	3	2	2	10	10
51	Jonah Bolden	C	24	PHI	4	0	14	2	3	0667	0	1	0000	2	2	10000	0667	0	2	0000	0	1	1	0	1	0	2	4	4
51	Jonah Bolden	C	24	PHO	3	0	33	2	8	0250	0	3	0000	2	5	0400	0250	2	2	10000	3	5	8	0	2	2	0	6	6
52	Marques Bolden	C	21	CLE	1	0	3	0	0	0	0	0	0	0	0	0	0	0	0	0	0	2	2	0	1	0	0	1	0
53	Jordan Bone	PG	22	DET	10	0	53	5	20	0250	2	10	0200	3	10	0300	0300	0	0	0	0	4	4	8	1	0	2	6	12
54	Isaac Bonga	SF	20	WAS	66	49	1250	118	234	0504	25	71	0352	93	163	0571	0558	69	85	0812	71	151	222	76	45	22	58	156	330
55	Devin Booker	SG	23	PHO	70	70	2512	627	1283	0489	141	398	0354	486	885	0549	0544	468	509	0919	29	268	297	456	49	18	264	213	1863
56	Chris Boucher	C	27	TOR	62	0	819	141	299	0472	38	118	0322	103	181	0569	0535	91	116	0784	107	170	277	26	22	61	28	114	411
57	Brian Bowen	SF	21	IND	6	1	31	3	10	0300	0	2	0000	3	8	0375	0300	0	0	0	1	6	7	0	0	1	1	3	6
58	Ky Bowman	PG	22	GSW	45	12	1015	134	321	0417	33	107	0308	101	214	0472	0469	34	41	0829	24	97	121	131	44	10	70	102	335
59	Avery Bradley	SG	29	LAL	49	44	1186	170	383	0444	63	173	0364	107	210	0510	0526	20	24	0833	18	97	115	63	43	5	47	110	423
60	Tony Bradley	C	22	UTA	58	3	663	126	189	0667	3	3	10000	123	186	0661	0675	30	46	0652	111	156	267	23	14	33	30	115	285
61	Jarrell Brantley	PF	23	UTA	9	0	96	10	28	0357	3	13	0231	7	15	0467	0411	1	2	0500	2	18	20	11	3	5	7	7	24
62	Ignas Brazdeikis	SF	21	NYK	9	0	53	6	22	0273	1	9	0111	5	13	0385	0295	4	5	0800	2	3	5	4	0	1	2	3	17
63	Corey Brewer	PF	33	SAC	5	0	33	2	4	0500	0	1	0000	2	3	0667	0500	1	3	0333	2	6	8	2	4	0	2	7	5
64	Mikal Bridges	SF	23	PHO	73	32	2042	247	484	0510	70	194	0361	177	290	0610	0583	103	122	0844	66	226	292	129	102	46	73	163	667
65	Miles Bridges	SF	21	CHO	65	64	1995	319	753	0424	99	300	0330	220	453	0486	0489	106	131	0809	88	274	362	114	40	48	95	132	843
66	Oshae Brissett	SF	21	TOR	19	0	135	13	36	0361	3	15	0200	10	21	0476	0403	8	10	0800	9	17	26	7	4	1	7	18	37
67	Ryan Broekhoff	SF	29	DAL	17	1	180	22	59	0373	20	51	0392	2	8	0250	0542	7	8	0875	5	38	43	11	5	4	6	15	71
68	Malcolm Brogdon	PG	27	IND	54	54	1666	326	744	0438	75	230	0326	251	514	0488	0489	166	186	0892	46	216	262	381	35	10	131	98	893
69	Dillon Brooks	SG	24	MEM	73	73	2112	435	1068	0407	147	411	0358	288	657	0438	0476	164	203	0808	68	175	243	150	63	27	124	278	1181
70	Bruce Brown	PG	23	DET	58	43	1634	198	447	0443	33	96	0344	165	351	0470	0480	88	119	0739	61	213	274	230	63	29	100	162	517
71	Charlie Brown Jr0	SG	22	ATL	10	0	40	6	19	0316	3	9	0333	3	10	0300	0395	5	5	10000	2	2	4	2	2	2	3	3	20
72	Jaylen Brown	SG	23	BOS	57	57	1934	427	887	0481	129	338	0382	298	549	0543	0554	176	243	0724	62	302	364	118	65	20	125	167	1159
73	Moses Brown	C	20	POR	9	0	33	4	10	0400	0	0	0	4	10	0400	0400	3	8	0375	3	11	14	1	1	1	3	7	11
74	Sterling Brown	SF	24	MIL	52	1	767	95	256	0371	44	136	0324	51	120	0425	0457	32	40	0800	31	152	183	51	29	7	42	54	266
75	Troy Brown Jr0	SF	20	WAS	69	22	1782	273	622	0439	61	179	0341	212	443	0479	0488	109	139	0784	76	307	383	178	85	7	79	132	716
76	Jalen Brunson	PG	23	DAL	57	16	1022	181	388	0466	43	120	0358	138	268	0515	0522	61	75	0813	22	112	134	188	22	4	66	74	466
77	Thomas Bryant	C	22	WAS	46	36	1147	243	418	0581	37	91	0407	206	327	0630	0626	86	116	0741	98	233	331	83	25	49	53	103	609
78	Reggie Bullock	SG	28	NYK	29	19	684	90	224	0402	37	111	0333	53	113	0469	0484	17	21	0810	13	55	68	42	25	3	19	56	234
79	Trey Burke	PG	27	TOT	33	1	520	94	209	0450	32	75	0427	62	134	0463	0526	23	29	0793	16	34	50	83	16	2	21	33	243
79	Trey Burke	PG	27	PHI	25	0	329	59	127	0465	16	38	0421	43	89	0483	0528	13	18	0722	15	20	35	53	7	1	12	21	147
79	Trey Burke	PG	27	DAL	8	1	191	35	82	0427	16	37	0432	19	45	0422	0524	10	11	0909	1	14	15	30	9	1	9	12	96
80	Alec Burks	SF-SG	28	TOT	66	19	1754	321	768	0418	116	301	0385	205	467	0439	0493	235	265	0887	48	234	282	189	62	17	91	128	993
80	Alec Burks	SF	28	GSW	48	18	1390	244	601	0406	84	224	0375	160	377	0424	0476	201	224	0897	37	189	226	151	50	17	76	107	773
80	Alec Burks	SG	28	PHI	18	1	364	77	167	0461	32	77	0416	45	90	0500	0557	34	41	0829	11	45	56	38	12	0	15	21	220
81	Deonte Burton	SF	26	OKC	39	0	356	43	125	0344	10	53	0189	33	72	0458	0384	8	14	0571	7	50	57	17	7	10	19	34	104
82	Jimmy Butler	SF	30	MIA	58	58	1959	345	758	0455	29	119	0244	316	639	0495	0474	438	525	0834	106	280	386	350	103	32	127	81	1157
83	Bruno Caboclo	C	24	TOT	30	0	244	38	89	0427	6	33	0182	32	56	0571	0461	8	9	0889	23	37	60	12	15	17	13	31	90
83	Bruno Caboclo	C	24	MEM	22	0	192	28	69	0406	4	25	0160	24	44	0545	0435	2	3	0667	17	27	44	10	10	12	7	23	62
83	Bruno Caboclo	C	24	HOU	8	0	52	10	20	0500	2	8	0250	8	12	0667	0550	6	6	10000	6	10	16	2	5	5	6	8	28
84	Devontae Cacok	C	23	LAL	1	0	9	3	6	0500	0	0	0	3	6	0500	0500	0	0	0	2	3	5	1	0	0	0	0	6
85	Kentavious Caldwell-Pope	SG	26	LAL	69	26	1762	237	507	0467	92	239	0385	145	268	0541	0558	79	102	0775	38	104	142	111	57	14	62	128	645
86	Vlatko Čančar	PF	22	DEN	14	0	45	6	15	0400	1	6	0167	5	9	0556	0433	4	4	10000	5	5	10	3	1	1	3	7	17
87	Clint Capela	C	25	HOU	39	39	1279	244	388	0629	0	0	0	244	388	0629	0629	55	104	0529	168	369	537	48	33	72	63	102	543
88	DeMarre Carroll	SF-C	33	TOT	24	0	290	25	66	0379	8	33	0242	17	33	0515	0439	29	42	0690	12	43	55	25	8	5	17	32	87
88	DeMarre Carroll	SF	33	SAS	15	0	135	9	29	0310	3	13	0231	6	16	0375	0362	12	20	0600	7	24	31	11	2	2	10	20	33
88	DeMarre Carroll	C	33	HOU	9	0	155	16	37	0432	5	20	0250	11	17	0647	0500	17	22	0773	5	19	24	14	6	3	7	12	54
89	Jevon Carter	PG	24	PHO	58	2	945	101	243	0416	62	146	0425	39	97	0402	0543	23	27	0852	30	88	118	84	47	17	32	86	287
90	Vince Carter	PF	43	ATL	60	0	876	107	304	0352	61	202	0302	46	102	0451	0452	23	29	0793	18	106	124	48	23	25	33	90	298
91	Wendell Carter Jr0	C	20	CHI	43	43	1256	183	343	0534	6	29	0207	177	314	0564	0542	112	152	0737	139	266	405	51	33	36	72	162	484
92	Michael Carter-Williams	SG	28	ORL	45	0	833	111	260	0427	22	75	0293	89	185	0481	0469	79	95	0832	46	101	147	109	49	22	52	87	323
93	Alex Caruso	PG	25	LAL	64	2	1175	120	291	0412	40	120	0333	80	171	0468	0481	69	94	0734	17	106	123	124	70	18	53	98	349
94	Willie Cauley-Stein	C	26	TOT	54	39	1097	175	302	0579	0	1	0000	175	301	0581	0579	40	66	0606	84	231	315	70	49	61	40	121	390
94	Willie Cauley-Stein	C	26	GSW	41	37	940	144	257	0560	0	0	0	144	257	0560	0560	35	57	0614	71	184	255	60	45	50	35	102	323
94	Willie Cauley-Stein	C	26	DAL	13	2	157	31	45	0689	0	1	0000	31	44	0705	0689	5	9	0556	13	47	60	10	4	11	5	19	67
95	Tyson Chandler	C	37	HOU	26	5	219	14	18	0778	0	0	0	14	18	0778	0778	6	13	0462	25	41	66	6	6	8	8	32	34
96	Wilson Chandler	PF	32	BRK	35	3	734	74	183	0404	37	121	0306	37	62	0597	0505	20	23	0870	11	134	145	39	16	12	34	79	205
97	Joe Chealey	PG	24	CHO	4	0	33	0	7	0000	0	4	0000	0	3	0000	0000	2	2	10000	0	0	0	1	4	0	2	2	2
98	Zylan Cheatham	PF	24	NOP	4	0	51	6	9	0667	0	1	0000	6	8	0750	0667	0	0	0	3	6	9	3	1	1	4	10	12
99	Chris Chiozza	PG	24	TOT	28	2	401	55	140	0393	27	72	0375	28	68	0412	0489	5	5	10000	9	44	53	83	21	4	32	37	142
99	Chris Chiozza	PG	24	WAS	10	0	123	10	34	0294	7	16	0438	3	18	0167	0397	0	0	0	0	15	15	28	10	2	9	12	27
99	Chris Chiozza	PG	24	BRK	18	2	278	45	106	0425	20	56	0357	25	50	0500	0519	5	5	10000	9	29	38	55	11	2	23	25	115
100	Marquese Chriss	PF	22	GSW	59	21	1196	210	385	0545	8	39	0205	202	346	0584	0556	120	156	0769	114	251	365	114	39	62	78	122	548
101	Gary Clark	SF-PF	25	TOT	42	5	567	54	133	0406	39	111	0351	15	22	0682	0553	9	10	0900	37	73	110	17	6	22	10	46	156
101	Gary Clark	PF	25	HOU	18	0	212	23	59	0390	18	51	0353	5	8	0625	0542	6	7	0857	11	29	40	12	2	7	2	21	70
101	Gary Clark	SF	25	ORL	24	5	355	31	74	0419	21	60	0350	10	14	0714	0561	3	3	10000	26	44	70	5	4	15	8	25	86
102	Brandon Clarke	PF	23	MEM	58	4	1300	296	479	0618	23	64	0359	273	415	0658	0642	85	112	0759	92	253	345	81	32	48	55	100	700
103	Jordan Clarkson	SG	27	TOT	71	2	1705	394	867	0454	152	413	0368	242	454	0533	0542	138	165	0836	50	137	187	136	46	16	97	108	1078
103	Jordan Clarkson	SG	27	CLE	29	0	666	144	326	0442	59	159	0371	85	167	0509	0532	76	86	0884	21	48	69	70	17	8	39	33	423
103	Jordan Clarkson	SG	27	UTA	42	2	1039	250	541	0462	93	254	0366	157	287	0547	0548	62	79	0785	29	89	118	66	29	8	58	75	655
104	Nic Claxton	C	20	BRK	15	0	187	27	48	0563	1	7	0143	26	41	0634	0573	11	21	0524	19	25	44	16	1	8	9	14	66
105	Chris Clemons	SG	22	HOU	33	0	291	57	142	0401	37	107	0346	20	35	0571	0532	10	11	0909	4	26	30	27	9	6	19	26	161
106	Antonius Cleveland	SG	25	DAL	11	0	46	4	14	0286	0	3	0000	4	11	0364	0286	3	5	0600	2	5	7	1	1	3	2	8	11
107	Amir Coffey	SG	22	LAC	18	1	159	23	54	0426	6	19	0316	17	35	0486	0481	6	11	0545	4	12	16	14	5	2	8	20	58
108	John Collins	PF	22	ATL	41	41	1363	353	605	0583	59	147	0401	294	458	0642	0632	120	150	0800	116	300	416	60	31	66	75	138	885
109	Zach Collins	PF	22	POR	11	11	290	32	68	0471	7	19	0368	25	49	0510	0522	6	8	0750	25	44	69	16	5	5	14	36	77
110	Mike Conley	PG	32	UTA	47	41	1363	232	567	0409	96	256	0375	136	311	0437	0494	115	139	0827	33	118	151	208	36	5	92	104	675
111	Pat Connaughton	SG	27	MIL	67	4	1243	137	301	0455	55	166	0331	82	135	0607	0547	31	40	0775	60	224	284	107	25	31	52	70	360
112	Quinn Cook	PG	26	LAL	44	1	508	91	214	0425	31	85	0365	60	129	0465	0498	11	14	0786	11	40	51	49	12	2	33	27	224
113	Tyler Cook	PF-SF	22	TOT	13	0	54	8	12	0667	0	0	0	8	12	0667	0667	7	8	0875	6	8	14	1	3	0	3	5	23
113	Tyler Cook	PF	22	CLE	11	0	35	7	10	0700	0	0	0	7	10	0700	0700	5	6	0833	4	6	10	1	1	0	1	4	19
113	Tyler Cook	SF	22	DEN	2	0	19	1	2	0500	0	0	0	1	2	0500	0500	2	2	10000	2	2	4	0	2	0	2	1	4
114	Robert Covington	PF-C	29	TOT	70	68	2137	305	723	0422	161	480	0335	144	243	0593	0533	99	124	0798	63	400	463	88	115	93	103	220	870
114	Robert Covington	PF	29	MIN	48	47	1411	216	496	0435	108	312	0346	108	184	0587	0544	75	94	0798	36	251	287	56	80	45	73	148	615
114	Robert Covington	C	29	HOU	22	21	726	89	227	0392	53	168	0315	36	59	0610	0509	24	30	0800	27	149	176	32	35	48	30	72	255
115	Allen Crabbe	SG-SF	27	TOT	37	1	653	63	177	0356	36	119	0303	27	58	0466	0458	10	14	0714	11	66	77	33	15	4	17	47	172
115	Allen Crabbe	SG	27	ATL	28	1	522	52	143	0364	30	93	0323	22	50	0440	0469	9	12	0750	10	55	65	28	15	4	12	36	143
115	Allen Crabbe	SF	27	MIN	9	0	131	11	34	0324	6	26	0231	5	8	0625	0412	1	2	0500	1	11	12	5	0	0	5	11	29
116	Torrey Craig	SF	29	DEN	58	27	1072	124	269	0461	45	138	0326	79	131	0603	0545	22	36	0611	63	126	189	47	23	36	25	135	315
117	Jamal Crawford	SG	39	BRK	1	0	6	2	4	0500	1	2	0500	1	2	0500	0625	0	0	0	0	0	0	3	0	0	0	1	5
118	Jae Crowder	SF-PF	29	TOT	65	53	1875	226	563	0401	135	394	0343	91	169	0538	0521	97	125	0776	52	332	384	161	72	24	69	143	684
118	Jae Crowder	SF	29	MEM	45	45	1322	147	399	0368	78	266	0293	69	133	0519	0466	75	95	0789	40	237	277	125	47	14	54	85	447
118	Jae Crowder	PF	29	MIA	20	8	553	79	164	0482	57	128	0445	22	36	0611	0655	22	30	0733	12	95	107	36	25	10	15	58	237
119	Jarrett Culver	SG	20	MIN	63	35	1506	230	569	0404	66	221	0299	164	348	0471	0462	54	117	0462	70	142	212	110	57	38	81	125	580
120	Seth Curry	SG	29	DAL	64	25	1576	284	574	0495	145	321	0452	139	253	0549	0621	80	97	0825	27	118	145	124	38	9	62	113	793
121	Stephen Curry	PG	31	GSW	5	5	139	33	82	0402	12	49	0245	21	33	0636	0476	26	26	10000	4	22	26	33	5	2	16	11	104
122	Troy Daniels	SG	28	TOT	47	0	532	72	186	0387	46	132	0348	26	54	0481	0511	10	16	0625	12	40	52	17	11	3	12	37	200
122	Troy Daniels	SG	28	LAL	41	0	456	62	158	0392	40	112	0357	22	46	0478	0519	10	16	0625	12	34	46	14	8	3	9	30	174
122	Troy Daniels	SG	28	DEN	6	0	76	10	28	0357	6	20	0300	4	8	0500	0464	0	0	0	0	6	6	3	3	0	3	7	26
123	Anthony Davis	PF	26	LAL	62	62	2131	551	1096	0503	72	218	0330	479	878	0546	0536	444	525	0846	142	435	577	200	91	143	154	156	1618
124	Ed Davis	C	30	UTA	28	1	303	22	46	0478	0	0	0	22	46	0478	0478	7	14	0500	35	70	105	12	11	9	13	61	51
125	Terence Davis	SG	22	TOR	72	4	1209	199	436	0456	94	242	0388	105	194	0541	0564	51	59	0864	50	187	237	115	39	14	76	124	543
126	Dewayne Dedmon	C	30	TOT	44	18	774	102	255	0400	22	107	0206	80	148	0541	0443	30	36	0833	60	189	249	22	25	41	57	133	256
126	Dewayne Dedmon	C	30	SAC	34	10	541	69	171	0404	14	71	0197	55	100	0550	0444	23	28	0821	46	121	167	15	15	26	47	93	175
126	Dewayne Dedmon	C	30	ATL	10	8	233	33	84	0393	8	36	0222	25	48	0521	0440	7	8	0875	14	68	82	7	10	15	10	40	81
127	Matthew Dellavedova	PG	29	CLE	57	4	821	62	175	0354	21	91	0231	41	84	0488	0414	32	37	0865	18	57	75	180	20	2	59	78	177
128	DeMar DeRozan	SF	30	SAS	68	68	2316	557	1049	0531	9	35	0257	548	1014	0540	0535	381	451	0845	44	331	375	380	70	20	164	180	1504
129	Cheick Diallo	C	23	PHO	47	2	479	92	142	0648	1	3	0333	91	139	0655	0651	34	39	0872	30	101	131	22	11	12	32	55	219
130	Hamidou Diallo	SF	21	OKC	46	3	896	132	296	0446	16	57	0281	116	239	0485	0473	38	63	0603	44	123	167	36	37	9	51	101	318
131	Gorgui Dieng	C	30	TOT	63	17	1096	166	364	0456	54	152	0355	112	212	0528	0530	78	101	0772	91	263	354	73	51	59	60	124	464
131	Gorgui Dieng	C	30	MIN	46	17	778	124	277	0448	46	120	0383	78	157	0497	0531	47	59	0797	73	183	256	58	37	42	44	89	341
131	Gorgui Dieng	C	30	MEM	17	0	318	42	87	0483	8	32	0250	34	55	0618	0529	31	42	0738	18	80	98	15	14	17	16	35	123
132	Spencer Dinwiddie	PG	26	BRK	64	49	1994	424	1021	0415	123	400	0308	301	621	0485	0476	347	446	0778	32	189	221	432	40	21	174	180	1318
133	Donte DiVincenzo	SG	23	MIL	66	24	1520	232	510	0455	83	247	0336	149	263	0567	0536	63	86	0733	66	252	318	154	85	20	90	113	610
134	Luka Dončić	PG	20	DAL	61	61	2047	581	1255	0463	171	541	0316	410	714	0574	0531	426	562	0758	78	495	573	538	62	14	260	153	1759
135	Luguentz Dort	SF	20	OKC	36	28	820	86	218	0394	30	101	0297	56	117	0479	0463	42	53	0792	24	57	81	27	31	4	22	97	244
136	Damyean Dotson	SG	25	NYK	48	0	836	120	290	0414	59	163	0362	61	127	0480	0516	22	33	0667	10	81	91	57	23	4	21	44	321
137	Sekou Doumbouya	PF	19	DET	38	19	754	92	236	0390	28	98	0286	64	138	0464	0449	31	46	0674	20	98	118	19	20	8	35	80	243
138	PJ Dozier	SG	23	DEN	29	0	412	65	157	0414	17	49	0347	48	108	0444	0468	21	29	0724	10	45	55	63	14	6	27	45	168
139	Goran Dragić	PG	33	MIA	59	3	1663	319	724	0441	124	338	0367	195	386	0505	0526	191	246	0776	29	158	187	301	40	10	144	124	953
140	Andre Drummond	C	26	TOT	57	56	1879	418	784	0533	5	35	0143	413	749	0551	0536	169	294	0575	250	614	864	152	109	93	203	201	1010
140	Andre Drummond	C	26	DET	49	48	1654	360	679	0530	1	21	0048	359	658	0546	0531	149	255	0584	226	549	775	138	97	82	174	176	870
140	Andre Drummond	C	26	CLE	8	8	225	58	105	0552	4	14	0286	54	91	0593	0571	20	39	0513	24	65	89	14	12	11	29	25	140
141	Jared Dudley	PF	34	LAL	45	1	364	24	60	0400	18	42	0429	6	18	0333	0550	2	2	10000	6	46	52	28	15	3	8	41	68
142	Kris Dunn	PG	25	CHI	51	32	1269	152	342	0444	29	112	0259	123	230	0535	0487	40	54	0741	23	163	186	173	101	17	68	158	373
143	Carsen Edwards	SG	21	BOS	37	0	351	42	128	0328	24	76	0316	18	52	0346	0422	13	19	0684	6	41	47	24	12	4	15	34	121
144	Henry Ellenson	C	23	BRK	5	0	15	1	7	0143	0	4	0000	1	3	0333	0143	0	0	0	2	4	6	1	0	0	0	1	2
145	Wayne Ellington	SG	32	NYK	36	1	558	61	174	0351	50	143	0350	11	31	0355	0494	11	13	0846	4	61	65	44	13	4	18	41	183
146	Joel Embiid	C	25	PHI	51	51	1506	382	801	0477	57	172	0331	325	629	0517	0512	351	435	0807	141	452	593	152	45	65	159	174	1172
147	James Ennis III	SF-SG	29	TOT	69	18	1265	160	359	0446	55	169	0325	105	190	0553	0522	79	98	0806	71	174	245	63	35	22	58	137	454
147	James Ennis III	SF	29	PHI	49	0	776	100	226	0442	37	106	0349	63	120	0525	0524	48	61	0787	48	102	150	41	23	14	31	85	285
147	James Ennis III	SG	29	ORL	20	18	489	60	133	0451	18	63	0286	42	70	0600	0519	31	37	0838	23	72	95	22	12	8	27	52	169
148	Drew Eubanks	C	22	SAS	22	3	272	43	67	0642	1	1	10000	42	66	0636	0649	20	26	0769	28	57	85	15	5	17	21	37	107
149	Jacob Evans	SG	22	TOT	29	1	418	45	134	0336	13	39	0333	32	95	0337	0384	25	29	0862	9	32	41	31	11	12	25	41	128
149	Jacob Evans	SG	22	GSW	27	1	414	45	133	0338	13	38	0342	32	95	0337	0387	25	29	0862	9	32	41	31	11	12	25	41	128
149	Jacob Evans	SG	22	MIN	2	0	4	0	1	0000	0	1	0000	0	0	0	0000	0	0	0	0	0	0	0	0	0	0	0	0
150	Dante Exum	SG	24	TOT	35	1	485	56	119	0471	15	43	0349	41	76	0539	0534	32	43	0744	12	55	67	40	13	8	31	38	159
150	Dante Exum	SG	24	UTA	11	0	83	10	23	0435	2	6	0333	8	17	0471	0478	2	2	10000	3	9	12	7	1	2	10	8	24
150	Dante Exum	SG	24	CLE	24	1	402	46	96	0479	13	37	0351	33	59	0559	0547	30	41	0732	9	46	55	33	12	6	21	30	135
151	Tacko Fall	C	24	BOS	7	0	33	11	14	0786	0	0	0	11	14	0786	0786	1	3	0333	1	14	15	1	1	4	3	7	23
152	Derrick Favors	C	28	NOP	51	49	1243	209	339	0617	1	7	0143	208	332	0627	0618	40	71	0563	163	338	501	81	30	46	55	107	459
153	Cristiano Felício	C	27	CHI	22	0	386	34	54	0630	0	2	0000	34	52	0654	0630	18	23	0783	55	47	102	16	10	2	18	34	86
154	Terrance Ferguson	SF	21	OKC	56	38	1257	78	220	0355	49	168	0292	29	52	0558	0466	15	20	0750	23	51	74	51	27	17	31	155	220
155	Bruno Fernando	C	21	ATL	56	13	713	103	199	0518	5	37	0135	98	162	0605	0530	29	51	0569	67	131	198	49	18	17	42	107	240
156	Yogi Ferrell	PG	26	SAC	50	0	530	79	188	0420	24	79	0304	55	109	0505	0484	36	42	0857	6	43	49	69	18	4	28	38	218
157	Dorian Finney-Smith	PF	26	DAL	71	68	2120	243	522	0466	114	303	0376	129	219	0589	0575	78	108	0722	145	260	405	114	45	39	69	178	678
158	Bryn Forbes	SG	26	SAS	63	62	1579	242	581	0417	148	381	0388	94	200	0470	0544	75	90	0833	12	114	126	108	33	0	57	113	707
159	Evan Fournier	SF	27	ORL	66	66	2076	434	929	0467	173	434	0399	261	495	0527	0560	180	220	0818	18	153	171	209	71	15	125	161	1221
160	De'Aaron Fox	PG	22	SAC	51	49	1634	391	815	0480	54	185	0292	337	630	0535	0513	241	342	0705	35	161	196	348	74	25	158	145	1077
161	Melvin Frazier	SG	23	ORL	19	0	126	15	34	0441	8	16	0500	7	18	0389	0559	2	4	0500	2	8	10	3	9	2	5	11	40
162	Michael Frazier	SG	25	HOU	13	0	145	7	29	0241	4	23	0174	3	6	0500	0310	9	14	0643	1	9	10	2	2	0	5	22	27
163	Tim Frazier	PG	29	DET	27	11	355	34	94	0362	10	30	0333	24	64	0375	0415	19	24	0792	9	24	33	93	14	4	36	42	97
164	Enes Freedom	C	27	BOS	58	7	983	199	348	0572	1	7	0143	198	341	0581	0573	70	99	0707	163	268	431	56	22	41	56	100	469
165	Markelle Fultz	PG	21	ORL	72	60	1996	359	772	0465	36	135	0267	323	637	0507	0488	116	159	0730	41	197	238	369	90	11	147	142	870
166	Wenyen Gabriel	PF	22	TOT	30	1	235	21	48	0438	6	20	0300	15	28	0536	0500	15	22	0682	21	31	52	8	11	7	16	39	63
166	Wenyen Gabriel	PF	22	SAC	11	0	61	6	17	0353	1	8	0125	5	9	0556	0382	6	10	0600	4	6	10	3	3	2	5	7	19
166	Wenyen Gabriel	PF	22	POR	19	1	174	15	31	0484	5	12	0417	10	19	0526	0565	9	12	0750	17	25	42	5	8	5	11	32	44
167	Daniel Gafford	C	21	CHI	43	7	609	94	134	0701	0	0	0	94	134	0701	0701	32	60	0533	52	54	106	21	13	56	29	98	220
168	Danilo Gallinari	PF	31	OKC	62	62	1834	358	817	0438	178	439	0405	180	378	0476	0547	266	298	0893	34	288	322	119	42	5	76	75	1160
169	Langston Galloway	SG	28	DET	66	6	1702	236	542	0435	132	331	0399	104	211	0493	0557	73	85	0859	33	116	149	101	48	11	40	96	677
170	Darius Garland	SG	20	CLE	59	59	1824	280	699	0401	105	296	0355	175	403	0434	0476	63	72	0875	27	84	111	229	42	4	151	92	728
171	Marc Gasol	C	35	TOR	44	43	1161	119	279	0427	57	148	0385	62	131	0473	0529	36	49	0735	31	244	275	147	34	38	59	124	331
172	Rudy Gay	PF	33	SAS	67	5	1461	266	596	0446	74	220	0336	192	376	0511	0508	120	136	0882	61	301	362	114	35	33	88	103	726
173	Paul George	SF	29	LAC	48	48	1419	343	782	0439	157	381	0412	186	401	0464	0539	190	217	0876	24	248	272	185	68	20	125	113	1033
174	Taj Gibson	C	34	NYK	62	56	1025	167	286	0584	4	14	0286	163	272	0599	0591	41	56	0732	111	156	267	52	27	30	47	122	379
175	Harry Giles	C	21	SAC	46	17	667	139	251	0554	0	2	0000	139	249	0558	0554	38	49	0776	43	145	188	60	22	18	44	119	316
176	Shai Gilgeous-Alexander	SG	21	OKC	70	70	2428	478	1015	0471	87	251	0347	391	764	0512	0514	288	357	0807	47	365	412	232	79	47	134	117	1331
177	Rudy Gobert	C	27	UTA	68	68	2333	386	557	0693	0	0	0	386	557	0693	0693	254	403	0630	230	686	916	101	51	135	130	215	1026
178	Brandon Goodwin	PG	24	ATL	34	1	430	76	190	0400	26	87	0299	50	103	0485	0468	28	30	0933	11	61	72	51	12	4	29	43	206
179	Aaron Gordon	PF	24	ORL	62	62	2017	335	767	0437	73	237	0308	262	530	0494	0484	151	224	0674	107	368	475	228	51	39	100	125	894
180	Eric Gordon	SF	31	HOU	36	15	1016	171	463	0369	96	303	0317	75	160	0469	0473	82	107	0766	9	62	71	54	23	13	43	70	520
181	Devonte' Graham	PG	24	CHO	63	53	2211	368	963	0382	218	585	0373	150	378	0397	0495	191	233	0820	42	170	212	471	62	15	181	115	1145
182	Treveon Graham	SF	26	TOT	55	20	929	87	242	0360	33	120	0275	54	122	0443	0428	36	56	0643	51	99	150	45	24	6	29	102	243
182	Treveon Graham	SF	26	MIN	33	20	663	62	175	0354	20	83	0241	42	92	0457	0411	27	37	0730	29	71	100	30	17	2	19	66	171
182	Treveon Graham	SF	26	ATL	22	0	266	25	67	0373	13	37	0351	12	30	0400	0470	9	19	0474	22	28	50	15	7	4	10	36	72
183	Jerami Grant	PF	25	DEN	71	24	1892	303	634	0478	98	252	0389	205	382	0537	0555	147	196	0750	58	190	248	88	50	57	63	154	851
184	Jerian Grant	SG	27	WAS	6	0	80	10	27	0370	2	8	0250	8	19	0421	0407	5	7	0714	2	4	6	9	1	1	3	11	27
185	Josh Gray	PG	26	NOP	2	0	23	1	2	0500	0	0	0	1	2	0500	0500	0	0	0	1	1	2	2	0	0	5	1	2
186	Danny Green	SG	32	LAL	68	68	1687	197	474	0416	120	327	0367	77	147	0524	0542	33	48	0688	51	174	225	91	85	32	63	136	547
187	Draymond Green	PF	29	GSW	43	43	1222	123	316	0389	36	129	0279	87	187	0465	0446	63	83	0759	23	243	266	266	59	33	98	110	345
188	JaMychal Green	PF	29	LAC	63	1	1307	151	352	0429	92	238	0387	59	114	0518	0560	36	48	0750	77	311	388	49	29	24	54	174	430
189	Javonte Green	SG	26	BOS	48	2	468	63	126	0500	9	33	0273	54	93	0581	0536	28	42	0667	24	69	93	26	24	8	23	43	163
190	Jeff Green	PF-C	33	TOT	48	4	960	159	344	0462	62	183	0339	97	161	0602	0552	73	91	0802	24	109	133	50	26	19	42	89	453
190	Jeff Green	PF	33	UTA	30	2	553	75	195	0385	34	104	0327	41	91	0451	0472	49	63	0778	14	67	81	20	12	10	27	46	233
190	Jeff Green	C	33	HOU	18	2	407	84	149	0564	28	79	0354	56	70	0800	0658	24	28	0857	10	42	52	30	14	9	15	43	220
191	Blake Griffin	PF	30	DET	18	18	512	88	250	0352	27	111	0243	61	139	0439	0406	76	98	0776	17	67	84	59	7	7	40	27	279
192	Marko Guduric	SG	24	MEM	44	0	484	62	157	0395	25	83	0301	37	74	0500	0475	24	26	0923	14	59	73	45	12	8	36	34	173
193	Kyle Guy	SG	22	SAC	3	0	10	2	5	0400	0	3	0000	2	2	10000	0400	0	0	0	0	1	1	1	0	0	0	1	4
194	Rui Hachimura	PF	21	WAS	48	48	1444	254	545	0466	25	87	0287	229	458	0500	0489	116	140	0829	78	216	294	87	37	8	53	105	649
195	Devon Hall	PG	24	OKC	11	0	81	6	30	0200	4	17	0235	2	13	0154	0267	4	8	0500	2	5	7	13	4	1	5	6	20
196	Donta Hall	C-PF	22	TOT	9	0	133	15	22	0682	0	0	0	15	22	0682	0682	9	18	0500	14	24	38	4	3	6	5	23	39
196	Donta Hall	PF	22	DET	4	0	48	1	4	0250	0	0	0	1	4	0250	0250	4	6	0667	6	9	15	2	1	1	2	9	6
196	Donta Hall	C	22	BRK	5	0	85	14	18	0778	0	0	0	14	18	0778	0778	5	12	0417	8	15	23	2	2	5	3	14	33
197	Dusty Hannahs	SG	26	MEM	2	0	13	4	9	0444	2	3	0667	2	6	0333	0556	2	2	10000	0	1	1	0	0	0	0	1	12
198	Tim Hardaway Jr0	SG	27	DAL	71	58	2091	384	884	0434	204	513	0398	180	371	0485	0550	149	182	0819	25	207	232	137	41	5	69	125	1121
199	James Harden	SG	30	HOU	68	68	2483	672	1514	0444	299	843	0355	373	671	0556	0543	692	800	0865	70	376	446	512	125	60	308	227	2335
200	Maurice Harkless	PF-SF	26	TOT	62	48	1427	142	283	0502	34	98	0347	108	185	0584	0562	39	66	0591	55	185	240	68	58	33	53	148	357
200	Maurice Harkless	PF	26	LAC	50	38	1141	112	217	0516	27	73	0370	85	144	0590	0578	24	42	0571	47	153	200	48	49	30	46	120	275
200	Maurice Harkless	SF	26	NYK	12	10	286	30	66	0455	7	25	0280	23	41	0561	0508	15	24	0625	8	32	40	20	9	3	7	28	82
201	Jared Harper	PG	22	PHO	3	0	8	1	4	0250	0	2	0000	1	2	0500	0250	0	0	0	0	0	0	0	0	0	0	0	2
202	Montrezl Harrell	C	26	LAC	63	2	1749	471	812	0580	0	18	0000	471	794	0593	0580	231	351	0658	163	282	445	107	39	72	108	146	1173
203	Gary Harris	SG	25	DEN	56	55	1780	218	519	0420	70	210	0333	148	309	0479	0487	75	92	0815	26	137	163	118	76	14	60	116	581
204	Joe Harris	SF	28	BRK	69	69	2123	381	784	0486	172	406	0424	209	378	0553	0596	64	89	0719	64	234	298	144	41	17	104	159	998
205	Tobias Harris	PF	27	PHI	72	72	2469	553	1173	0471	131	357	0367	422	816	0517	0527	174	216	0806	69	426	495	227	53	40	104	165	1411
206	Shaquille Harrison	SG	26	CHI	43	10	484	77	165	0467	16	42	0381	61	123	0496	0515	39	50	0780	22	64	86	49	34	19	19	55	209
207	Josh Hart	SF	24	NOP	65	16	1755	225	532	0423	121	354	0342	104	178	0584	0537	85	115	0739	61	364	425	108	63	23	75	160	656
208	Isaiah Hartenstein	C	21	HOU	23	2	266	44	67	0657	0	5	0000	44	62	0710	0657	19	28	0679	29	61	90	18	9	12	16	41	107
209	Udonis Haslem	C	39	MIA	4	1	44	4	11	0364	1	3	0333	3	8	0375	0409	3	4	0750	1	15	16	1	0	0	1	6	12
210	Jaxson Hayes	C	19	NOP	64	14	1080	174	259	0672	1	4	0250	173	255	0678	0674	123	190	0647	97	162	259	56	26	55	53	161	472
211	Gordon Hayward	SF	29	BOS	52	52	1740	350	700	0500	85	222	0383	265	478	0554	0561	124	145	0855	55	293	348	212	38	22	96	96	909
212	John Henson	C	29	TOT	40	8	600	95	171	0556	8	36	0222	87	135	0644	0579	23	46	0500	46	116	162	54	24	42	36	78	221
212	John Henson	C	29	CLE	29	2	412	61	120	0508	6	31	0194	55	89	0618	0533	17	33	0515	32	82	114	43	16	32	21	55	145
212	John Henson	C	29	DET	11	6	188	34	51	0667	2	5	0400	32	46	0696	0686	6	13	0462	14	34	48	11	8	10	15	23	76
213	Dewan Hernandez	C	23	TOR	6	0	28	5	14	0357	1	2	0500	4	12	0333	0393	3	5	0600	5	9	14	3	1	0	3	6	14
214	Juancho Hernangómez	PF	24	TOT	48	14	833	100	247	0405	44	129	0341	56	118	0475	0494	44	71	0620	43	154	197	40	19	9	32	64	288
214	Juancho Hernangómez	PF	24	DEN	34	0	422	38	110	0345	15	60	0250	23	50	0460	0414	16	25	0640	24	71	95	22	5	5	18	29	107
214	Juancho Hernangómez	PF	24	MIN	14	14	411	62	137	0453	29	69	0420	33	68	0485	0558	28	46	0609	19	83	102	18	14	4	14	35	181
215	Willy Hernangómez	C	25	CHO	31	0	375	74	139	0532	5	22	0227	69	117	0590	0550	37	59	0627	43	91	134	29	10	7	30	32	190
216	Tyler Herro	SG	20	MIA	55	8	1508	270	631	0428	116	298	0389	154	333	0462	0520	87	100	0870	16	208	224	121	34	9	87	76	743
217	Kevin Hervey	PF	23	OKC	10	0	52	7	27	0259	3	20	0150	4	7	0571	0315	0	0	0	1	11	12	5	1	1	0	4	17
218	Mario Hezonja	PF	24	POR	53	4	871	92	218	0422	24	78	0308	68	140	0486	0477	48	59	0814	30	154	184	50	36	9	42	107	256
219	Buddy Hield	SG	27	SAC	72	44	2216	498	1162	0429	271	688	0394	227	474	0479	0545	115	136	0846	57	271	328	213	66	17	168	165	1382
220	George Hill	PG	33	MIL	59	2	1271	194	376	0516	81	176	0460	113	200	0565	0624	85	101	0842	50	127	177	180	47	5	57	84	554
221	Solomon Hill	PF	28	TOT	59	4	1088	110	278	0396	63	171	0368	47	107	0439	0509	40	54	0741	29	136	165	104	43	12	51	85	323
221	Solomon Hill	PF	28	MEM	48	3	901	96	233	0412	56	147	0381	40	86	0465	0532	26	38	0684	24	120	144	94	31	7	40	73	274
221	Solomon Hill	PF	28	MIA	11	1	187	14	45	0311	7	24	0292	7	21	0333	0389	14	16	0875	5	16	21	10	12	5	11	12	49
222	Jaylen Hoard	PF	20	POR	13	0	103	15	32	0469	0	3	0000	15	29	0517	0469	8	13	0615	14	18	32	4	5	0	4	12	38
223	Aaron Holiday	PG	23	IND	66	33	1617	233	563	0414	87	221	0394	146	342	0427	0491	74	87	0851	22	134	156	225	55	16	88	120	627
224	Jrue Holiday	SG	29	NOP	61	61	2117	458	1006	0455	122	346	0353	336	660	0509	0516	129	182	0709	77	216	293	408	99	48	184	145	1167
225	Justin Holiday	SF	30	IND	73	6	1826	208	486	0428	134	331	0405	74	155	0477	0566	53	67	0791	32	206	238	93	87	46	44	137	603
226	Rondae Hollis-Jefferson	PF	25	TOR	60	6	1122	155	329	0471	3	23	0130	152	306	0497	0476	105	143	0734	110	173	283	106	46	23	59	115	418
227	Richaun Holmes	C	26	SAC	44	38	1242	223	344	0648	0	0	0	223	344	0648	0648	93	118	0788	127	231	358	42	41	56	52	169	539
228	Rodney Hood	SF	27	POR	21	21	619	87	172	0506	35	71	0493	52	101	0515	0608	21	27	0778	10	62	72	32	17	4	19	46	230
229	Al Horford	C	33	PHI	67	61	2025	319	709	0450	99	283	0350	220	426	0516	0520	61	80	0763	103	353	456	270	52	61	80	142	798
230	Talen Horton-Tucker	SG	19	LAL	6	1	81	14	30	0467	4	13	0308	10	17	0588	0533	2	4	0500	2	5	7	6	8	1	6	10	34
231	Danuel House Jr0	SF	26	HOU	63	52	1913	230	539	0427	129	355	0363	101	184	0549	0546	73	90	0811	57	210	267	85	67	34	54	132	662
232	Dwight Howard	C	34	LAL	69	2	1306	202	277	0729	3	5	0600	199	272	0732	0735	110	214	0514	172	335	507	45	31	79	84	222	517
233	William Howard	PF	26	HOU	2	0	13	0	4	0000	0	4	0000	0	0	0	0000	0	0	0	0	2	2	1	0	0	1	1	0
234	Kevin Huerter	SG	21	ATL	56	48	1760	252	610	0413	127	334	0380	125	276	0453	0517	53	64	0828	35	193	228	213	51	27	87	139	684
235	De'Andre Hunter	SF	22	ATL	63	62	2018	280	683	0410	108	304	0355	172	379	0454	0489	110	144	0764	44	242	286	112	44	18	103	182	778
236	Chandler Hutchison	SF	23	CHI	28	10	527	80	175	0457	12	38	0316	68	137	0496	0491	46	78	0590	18	90	108	26	27	7	27	47	218
237	Serge Ibaka	C	30	TOR	55	27	1485	343	670	0512	70	182	0385	273	488	0559	0564	89	124	0718	114	338	452	77	28	46	109	153	845
238	Andre Iguodala	SF	36	MIA	21	0	418	38	88	0432	14	47	0298	24	41	0585	0511	6	15	0400	17	61	78	51	14	21	26	35	96
239	Ersan İlyasova	PF	32	MIL	63	8	986	146	313	0466	50	137	0365	96	176	0545	0546	72	87	0828	62	240	302	49	24	17	34	95	414
240	Joe Ingles	PF	32	UTA	72	45	2137	246	553	0445	141	353	0399	105	200	0525	0572	74	94	0787	27	251	278	373	65	11	142	154	707
241	Brandon Ingram	PF	22	NOP	62	62	2104	507	1096	0463	150	384	0391	357	712	0501	0531	313	368	0851	51	329	380	259	61	38	189	179	1477
242	Kyrie Irving	PG	27	BRK	20	20	658	199	416	0478	56	142	0394	143	274	0522	0546	94	102	0922	22	81	103	128	27	10	52	53	548
243	Jonathan Isaac	PF	22	ORL	34	32	980	156	332	0470	32	94	0340	124	238	0521	0518	60	77	0779	58	173	231	48	53	78	49	83	404
244	Wes Iwundu	SF	25	ORL	52	21	953	97	233	0416	28	82	0341	69	151	0457	0476	78	97	0804	24	107	131	60	25	13	26	80	300
245	Frank Jackson	PG	21	NOP	59	2	797	134	331	0405	47	144	0326	87	187	0465	0476	56	75	0747	22	61	83	61	17	4	49	77	371
246	Jaren Jackson Jr0	C	20	MEM	57	57	1622	353	753	0469	145	368	0394	208	385	0540	0565	139	186	0747	55	207	262	78	40	92	99	232	990
247	Josh Jackson	SF	22	MEM	22	0	381	70	159	0440	23	72	0319	47	87	0540	0513	35	50	0700	11	55	66	35	18	9	28	40	198
248	Justin Jackson	PF	24	DAL	65	3	1045	135	341	0396	48	163	0294	87	178	0489	0466	42	50	0840	27	127	154	52	15	10	14	69	360
249	Reggie Jackson	PG	29	TOT	31	16	743	134	326	0411	57	145	0393	77	181	0425	0498	45	54	0833	17	75	92	126	13	5	51	59	370
249	Reggie Jackson	PG	29	DET	14	10	381	76	198	0384	31	82	0378	45	116	0388	0462	26	33	0788	11	30	41	72	8	1	23	21	209
249	Reggie Jackson	PG	29	LAC	17	6	362	58	128	0453	26	63	0413	32	65	0492	0555	19	21	0905	6	45	51	54	5	4	28	38	161
250	Justin James	SF	23	SAC	36	0	232	35	84	0417	9	29	0310	26	55	0473	0470	10	21	0476	6	26	32	18	6	9	8	17	89
251	LeBron James	PG	35	LAL	67	67	2316	643	1303	0493	148	425	0348	495	878	0564	0550	264	381	0693	66	459	525	684	78	36	261	118	1698
252	Amile Jefferson	PF	26	ORL	18	0	74	5	14	0357	0	0	0	5	14	0357	0357	5	14	0357	10	13	23	4	1	3	3	7	15
253	DaQuan Jeffries	SG	22	SAC	13	0	141	20	40	0500	5	18	0278	15	22	0682	0563	5	6	0833	3	15	18	7	4	1	2	19	50
254	Ty Jerome	SG	22	PHO	31	0	328	38	113	0336	14	50	0280	24	63	0381	0398	12	16	0750	7	39	46	44	15	3	18	29	102
255	Alize Johnson	PF	23	IND	17	1	118	12	29	0414	3	8	0375	9	21	0429	0466	7	10	0700	16	32	48	7	3	2	7	12	34
256	B0J0 Johnson	SF	24	ORL	10	0	83	9	32	0281	3	9	0333	6	23	0261	0328	9	10	0900	3	12	15	3	3	0	6	3	30
257	Cameron Johnson	PF	23	PHO	57	9	1255	176	405	0435	106	272	0390	70	133	0526	0565	46	57	0807	49	138	187	69	36	20	32	88	504
258	James Johnson	PF-C	32	TOT	32	1	619	103	215	0479	33	91	0363	70	124	0565	0556	31	48	0646	25	93	118	74	25	32	48	80	270
258	James Johnson	PF	32	MIA	18	0	281	39	87	0448	16	45	0356	23	42	0548	0540	8	14	0571	8	44	52	21	6	13	15	34	102
258	James Johnson	C	32	MIN	14	1	338	64	128	0500	17	46	0370	47	82	0573	0566	23	34	0676	17	49	66	53	19	19	33	46	168
259	Keldon Johnson	SF	20	SAS	17	1	301	53	89	0596	13	22	0591	40	67	0597	0669	35	44	0795	10	47	57	15	14	2	13	28	154
260	Stanley Johnson	PF	23	TOR	25	0	150	22	59	0373	7	24	0292	15	35	0429	0432	9	16	0563	7	30	37	20	6	4	15	16	60
261	Tyler Johnson	PG-SG	27	TOT	39	7	709	97	250	0388	38	119	0319	59	131	0450	0464	42	50	0840	18	58	76	74	16	9	29	58	274
261	Tyler Johnson	PG	27	PHO	31	3	515	65	171	0380	24	83	0289	41	88	0466	0450	24	32	0750	10	42	52	50	12	8	24	43	178
261	Tyler Johnson	SG	27	BRK	8	4	194	32	79	0405	14	36	0389	18	43	0419	0494	18	18	10000	8	16	24	24	4	1	5	15	96
262	Nikola Jokić	C	24	DEN	73	73	2336	565	1071	0528	80	255	0314	485	816	0594	0565	246	301	0817	166	545	711	512	85	44	226	222	1456
263	Damian Jones	C	24	ATL	55	27	887	121	178	0680	2	9	0222	119	169	0704	0685	62	84	0738	74	132	206	35	26	40	28	149	306
264	Derrick Jones Jr0	SF	22	MIA	59	16	1375	184	349	0527	37	132	0280	147	217	0677	0580	95	123	0772	66	167	233	62	58	38	30	130	500
265	Tyus Jones	PG	23	MEM	65	6	1232	197	429	0459	47	124	0379	150	305	0492	0514	43	58	0741	9	94	103	285	59	6	55	44	484
266	DeAndre Jordan	C	31	BRK	56	6	1234	191	287	0666	0	0	0	191	287	0666	0666	83	122	0680	141	420	561	105	18	52	74	114	465
267	Cory Joseph	PG	28	SAC	72	26	1759	171	412	0415	56	159	0352	115	253	0455	0483	60	70	0857	44	144	188	251	53	21	80	133	458
268	Mfiondu Kabengele	C	22	LAC	12	0	64	14	32	0438	9	20	0450	5	12	0417	0578	5	5	10000	1	10	11	2	2	2	2	9	42
269	Frank Kaminsky	C	26	PHO	39	13	777	138	307	0450	41	124	0331	97	183	0530	0516	61	90	0678	35	141	176	75	14	10	37	75	378
270	Luke Kennard	SG	23	DET	28	25	922	151	342	0442	73	183	0399	78	159	0491	0548	67	75	0893	9	89	98	115	12	6	43	65	442
271	Stanton Kidd	SG	27	UTA	4	0	15	0	3	0000	0	1	0000	0	2	0000	0000	0	0	0	0	3	3	1	0	0	2	3	0
272	Michael Kidd-Gilchrist	PF	26	TOT	25	0	281	22	66	0333	5	20	0250	17	46	0370	0371	11	14	0786	14	53	67	14	2	6	16	37	60
272	Michael Kidd-Gilchrist	PF	26	CHO	12	0	160	18	53	0340	5	17	0294	13	36	0361	0387	7	9	0778	9	26	35	10	0	3	7	18	48
272	Michael Kidd-Gilchrist	PF	26	DAL	13	0	121	4	13	0308	0	3	0000	4	10	0400	0308	4	5	0800	5	27	32	4	2	3	9	19	12
273	Louis King	SF	20	DET	10	0	62	8	21	0381	4	11	0364	4	10	0400	0476	0	3	0000	1	9	10	5	2	0	2	10	20
274	Maxi Kleber	PF	28	DAL	74	21	1890	237	514	0461	119	319	0373	118	195	0605	0577	79	93	0849	112	276	388	88	25	83	58	176	672
275	Brandon Knight	SG-PG	28	TOT	25	3	462	59	167	0353	45	131	0344	14	36	0389	0488	20	34	0588	4	37	41	69	10	3	38	40	183
275	Brandon Knight	SG	28	CLE	16	0	241	28	86	0326	19	64	0297	9	22	0409	0436	4	13	0308	3	17	20	31	5	2	16	20	79
275	Brandon Knight	PG	28	DET	9	3	221	31	81	0383	26	67	0388	5	14	0357	0543	16	21	0762	1	20	21	38	5	1	22	20	104
276	Kevin Knox	SF	20	NYK	65	4	1166	144	401	0359	65	199	0327	79	202	0391	0440	66	101	0653	28	156	184	61	23	28	45	106	419
277	John Konchar	SG	23	MEM	19	0	181	24	37	0649	5	10	0500	19	27	0704	0716	1	2	0500	18	29	47	22	7	3	7	7	54
278	Furkan Korkmaz	SG	22	PHI	72	12	1559	242	563	0430	143	356	0402	99	207	0478	0557	77	102	0755	18	150	168	79	41	16	59	98	704
279	Luke Kornet	C	24	CHI	36	14	559	82	187	0439	31	108	0287	51	79	0646	0521	20	28	0714	22	62	84	32	11	26	14	54	215
280	Kyle Korver	SF	38	MIL	58	1	960	126	293	0430	99	237	0418	27	56	0482	0599	35	41	0854	15	107	122	68	26	12	48	78	386
281	Rodions Kurucs	PF	21	BRK	47	9	684	79	177	0446	33	90	0367	46	87	0529	0540	24	38	0632	25	112	137	51	25	5	46	90	215
282	Kyle Kuzma	PF	24	LAL	61	9	1526	291	668	0436	86	272	0316	205	396	0518	0500	114	155	0735	52	221	273	80	28	26	91	126	782
283	Skal Labissière	C	23	POR	33	1	567	81	147	0551	3	13	0231	78	134	0582	0561	25	33	0758	65	104	169	42	7	31	30	89	190
284	Jeremy Lamb	SG	27	IND	46	42	1291	216	479	0451	53	158	0335	163	321	0508	0506	92	110	0836	24	176	200	96	55	22	50	104	577
285	Romeo Langford	SG	20	BOS	32	2	370	28	80	0350	5	27	0185	23	53	0434	0381	18	25	0720	15	26	41	13	8	8	11	33	79
286	Zach LaVine	SF	24	CHI	60	60	2085	539	1199	0450	184	484	0380	355	715	0497	0526	268	334	0802	41	248	289	254	88	28	206	131	1530
287	Vic Law	PF	24	ORL	8	0	62	6	18	0333	1	7	0143	5	11	0455	0361	2	6	0333	2	9	11	3	2	0	2	6	15
288	Jake Layman	SF	25	MIN	23	2	505	81	179	0453	24	72	0333	57	107	0533	0520	24	32	0750	17	40	57	15	17	10	24	47	210
289	T0J0 Leaf	PF	22	IND	28	1	222	36	86	0419	5	18	0278	31	68	0456	0448	7	16	0438	23	48	71	9	10	4	8	22	84
290	Jalen Lecque	SG	19	PHO	5	0	32	4	10	0400	0	4	0000	4	6	0667	0400	2	2	10000	0	2	2	2	0	0	2	3	10
291	Courtney Lee	SG	34	DAL	24	9	345	40	82	0488	21	47	0447	19	35	0543	0616	6	7	0857	7	25	32	12	18	6	11	33	107
292	Damion Lee	SG	27	GSW	49	36	1423	213	511	0417	85	239	0356	128	272	0471	0500	110	126	0873	32	207	239	133	50	6	67	116	621
293	Alex Len	C	26	TOT	55	12	970	177	319	0555	16	59	0271	161	260	0619	0580	68	105	0648	100	221	321	50	23	48	55	127	438
293	Alex Len	C	26	ATL	40	9	745	142	260	0546	14	56	0250	128	204	0627	0573	51	81	0630	69	161	230	42	20	33	39	93	349
293	Alex Len	C	26	SAC	15	3	225	35	59	0593	2	3	0667	33	56	0589	0610	17	24	0708	31	60	91	8	3	15	16	34	89
294	Kawhi Leonard	SF	28	LAC	57	57	1848	532	1133	0470	123	325	0378	409	808	0506	0524	356	402	0886	54	348	402	280	103	33	149	113	1543
295	Meyers Leonard	C	27	MIA	51	49	1034	119	234	0509	53	128	0414	66	106	0623	0622	18	28	0643	30	230	260	55	14	15	39	107	309
296	Caris LeVert	SG	25	BRK	45	31	1330	311	732	0425	80	220	0364	231	512	0451	0480	140	197	0711	49	140	189	199	53	10	118	81	842
297	Damian Lillard	PG	29	POR	66	66	2474	624	1349	0463	270	674	0401	354	675	0524	0563	460	518	0888	33	251	284	530	70	22	194	114	1978
298	Nassir Little	PF	19	POR	48	5	573	65	151	0430	14	59	0237	51	92	0554	0477	28	44	0636	31	77	108	22	13	14	15	72	172
299	Kevon Looney	C	23	GSW	20	4	262	29	79	0367	1	14	0071	28	65	0431	0373	9	12	0750	28	38	66	20	12	6	12	34	68
300	Brook Lopez	C	31	MIL	68	67	1817	292	671	0435	102	325	0314	190	346	0549	0511	127	152	0836	58	254	312	99	46	163	70	163	813
301	Robin Lopez	C	31	MIL	66	5	958	147	299	0492	35	105	0333	112	194	0577	0550	28	53	0528	56	105	161	45	10	45	63	96	357
302	Kevin Love	PF	31	CLE	56	56	1780	327	727	0450	146	390	0374	181	337	0537	0550	187	219	0854	54	493	547	178	33	19	140	90	987
303	Kyle Lowry	PG	33	TOR	58	58	2098	334	803	0416	164	466	0352	170	337	0504	0518	294	343	0857	32	260	292	433	82	26	178	190	1126
304	Timothé Luwawu-Cabarrot	SF	24	BRK	47	2	853	117	269	0435	62	160	0388	55	109	0505	0550	69	81	0852	29	98	127	29	18	7	37	106	365
305	Trey Lyles	PF	24	SAS	63	53	1271	153	343	0446	65	168	0387	88	175	0503	0541	33	45	0733	71	290	361	69	28	28	39	98	404
306	Daryl Macon	PG	24	MIA	4	0	14	1	3	0333	1	2	0500	0	1	0000	0500	0	0	0	0	0	0	1	0	0	2	1	3
307	J0P0 Macura	SG	24	CLE	1	0	1	0	0	0	0	0	0	0	0	0	0	0	0	0	0	0	0	0	0	0	0	0	0
308	Josh Magette	PG	30	ORL	8	0	38	5	15	0333	1	4	0250	4	11	0364	0367	1	2	0500	1	5	6	5	3	1	5	4	12
309	Ian Mahinmi	C	33	WAS	38	35	808	104	210	0495	5	26	0192	99	184	0538	0507	70	113	0619	78	140	218	49	31	44	45	114	283
310	Thon Maker	C	22	DET	60	14	776	93	193	0482	22	64	0344	71	129	0550	0539	73	110	0664	54	113	167	43	25	39	45	102	281
311	Terance Mann	SF	23	LAC	41	6	362	37	79	0468	7	20	0350	30	59	0508	0513	18	27	0667	10	45	55	53	11	5	18	46	99
312	Boban Marjanović	C	31	DAL	44	5	422	121	211	0573	4	17	0235	117	194	0603	0583	43	57	0754	66	131	197	20	8	10	30	56	289
313	Lauri Markkanen	PF	22	CHI	50	50	1492	251	591	0425	109	317	0344	142	274	0518	0517	126	153	0824	60	253	313	74	42	23	81	96	737
314	Caleb Martin	SF	24	CHO	18	1	317	37	84	0440	20	37	0541	17	47	0362	0560	17	21	0810	10	28	38	23	12	7	15	32	111
315	Cody Martin	SF	24	CHO	48	3	903	89	207	0430	18	77	0234	71	130	0546	0473	42	65	0646	38	120	158	95	39	9	44	78	238
316	Jeremiah Martin	PG	23	BRK	9	0	99	24	53	0453	5	18	0278	19	35	0543	0500	11	14	0786	1	9	10	18	7	2	4	7	64
317	Kelan Martin	SF	24	MIN	31	4	495	71	181	0392	25	96	0260	46	85	0541	0461	30	31	0968	12	84	96	23	7	9	20	51	197
318	Frank Mason III	PG	25	MIL	9	0	118	23	51	0451	6	21	0286	17	30	0567	0510	10	17	0588	5	14	19	29	5	1	11	11	62
319	Garrison Mathews	SG	23	WAS	18	0	227	24	56	0429	19	46	0413	5	10	0500	0598	31	34	0912	6	18	24	10	8	1	8	32	98
320	Wesley Matthews	SG	33	MIL	67	67	1635	167	422	0396	108	297	0364	59	125	0472	0524	52	68	0765	22	144	166	92	38	9	43	103	494
321	Luc Mbah a Moute	PF	33	HOU	3	0	25	2	5	0400	0	2	0000	2	3	0667	0400	1	2	0500	1	1	2	0	2	0	1	0	5
322	Patrick McCaw	SF	24	TOR	37	12	908	67	162	0414	23	71	0324	44	91	0484	0485	13	18	0722	19	67	86	79	39	4	29	60	170
323	CJ McCollum	SG	28	POR	70	70	2556	611	1356	0451	194	512	0379	417	844	0494	0522	140	185	0757	46	251	297	310	54	42	127	183	1556
324	T0J0 McConnell	PG	27	IND	71	3	1326	212	411	0516	5	17	0294	207	394	0525	0522	35	42	0833	38	151	189	355	56	11	100	73	464
325	Jalen McDaniels	SF	22	CHO	16	0	293	33	70	0471	9	24	0375	24	46	0522	0536	14	17	0824	15	50	65	13	8	3	11	36	89
326	Doug McDermott	PF	28	IND	69	0	1372	267	547	0488	128	294	0435	139	253	0549	0605	48	58	0828	26	148	174	78	12	5	42	117	710
327	JaVale McGee	C	32	LAL	68	68	1130	195	306	0637	3	6	0500	192	300	0640	0642	53	82	0646	125	265	390	37	36	94	55	159	446
328	Rodney McGruder	SG	28	LAC	56	4	871	72	181	0398	24	89	0270	48	92	0522	0464	19	34	0559	29	122	151	36	26	8	24	74	187
329	Alfonzo McKinnie	SF	27	CLE	40	1	593	73	171	0427	14	65	0215	59	106	0557	0468	22	31	0710	37	76	113	14	23	8	26	72	182
330	Jordan McLaughlin	PG	23	MIN	30	2	590	87	178	0489	29	76	0382	58	102	0569	0570	26	39	0667	7	42	49	125	34	4	31	31	229
331	Ben McLemore	SF	26	HOU	71	23	1619	242	545	0444	181	452	0400	61	93	0656	0610	50	67	0746	21	136	157	58	45	16	50	155	715
332	Jordan McRae	SG	28	TOT	37	4	784	149	366	0407	45	126	0357	104	240	0433	0469	83	109	0761	18	106	124	93	21	16	43	73	426
332	Jordan McRae	SG	28	WAS	29	4	654	133	317	0420	40	106	0377	93	211	0441	0483	64	83	0771	17	87	104	82	19	15	38	61	370
332	Jordan McRae	SG	28	DEN	4	0	32	2	6	0333	2	4	0500	0	2	0000	0500	3	4	0750	1	4	5	4	2	1	0	2	9
332	Jordan McRae	SG	28	DET	4	0	98	14	43	0326	3	16	0188	11	27	0407	0360	16	22	0727	0	15	15	7	0	0	5	10	47
333	Nicolò Melli	C	29	NOP	60	8	1042	136	323	0421	69	206	0335	67	117	0573	0528	54	73	0740	38	142	180	82	34	23	46	124	395
334	De'Anthony Melton	PG	21	MEM	60	8	1167	161	401	0401	40	140	0286	121	261	0464	0451	93	121	0769	43	177	220	175	77	20	84	109	455
335	Chimezie Metu	C	22	SAS	18	0	105	24	42	0571	0	2	0000	24	40	0600	0571	10	13	0769	12	21	33	10	3	6	10	7	58
336	Khris Middleton	SF	28	MIL	62	59	1853	471	947	0497	147	354	0415	324	593	0546	0575	208	227	0916	44	338	382	265	53	7	137	142	1297
337	Eric Mika	C	25	SAC	1	0	19	2	3	0667	0	0	0	2	3	0667	0667	2	2	10000	2	5	7	0	0	0	0	5	6
338	C0J0 Miles	SF	32	WAS	10	0	161	19	59	0322	11	35	0314	8	24	0333	0415	15	20	0750	4	8	12	12	10	4	4	14	64
339	Malcolm Miller	SF	26	TOR	28	1	162	12	29	0414	8	22	0364	4	7	0571	0552	3	8	0375	2	14	16	11	5	2	4	18	35
340	Patty Mills	PG	31	SAS	66	1	1485	258	598	0431	154	403	0382	104	195	0533	0560	97	112	0866	22	86	108	118	53	6	54	105	767
341	Paul Millsap	PF	34	DEN	51	48	1240	211	438	0482	54	124	0435	157	314	0500	0543	115	141	0816	98	195	293	83	44	30	70	150	591
342	Shake Milton	SG	23	PHI	40	24	805	134	277	0484	58	135	0430	76	142	0535	0588	51	65	0785	15	73	88	104	20	7	47	92	377
343	Donovan Mitchell	SG	23	UTA	69	69	2364	602	1342	0449	173	473	0366	429	869	0494	0513	278	322	0863	53	251	304	294	70	14	184	172	1655
344	Naz Mitrou-Long	SG	26	IND	5	0	47	6	17	0353	2	12	0167	4	5	0800	0412	0	0	0	0	7	7	8	1	1	3	2	14
345	Adam Mokoka	SF	21	CHI	11	0	112	12	28	0429	6	15	0400	6	13	0462	0536	2	4	0500	7	3	10	4	4	0	2	17	32
346	Malik Monk	SG	21	CHO	55	1	1169	212	488	0434	58	204	0284	154	284	0542	0494	82	100	0820	27	130	157	114	25	16	77	74	564
347	Matt Mooney	SG	23	CLE	4	0	19	1	4	0250	0	2	0000	1	2	0500	0250	0	0	0	0	3	3	1	2	1	0	1	2
348	E'Twaun Moore	SG	30	NOP	56	6	1020	186	437	0426	63	167	0377	123	270	0456	0498	31	45	0689	31	100	131	78	32	11	40	80	466
349	Ja Morant	PG	20	MEM	67	67	2074	447	937	0477	60	179	0335	387	758	0511	0509	239	308	0776	51	208	259	488	58	18	220	110	1193
350	Juwan Morgan	PF	22	UTA	21	0	134	15	26	0577	3	8	0375	12	18	0667	0635	3	4	0750	10	19	29	6	1	2	6	19	36
351	Marcus Morris	SF-PF	30	TOT	62	62	1936	355	810	0438	142	348	0408	213	462	0461	0526	181	220	0823	59	252	311	86	47	30	97	180	1033
351	Marcus Morris	SF	30	NYK	43	43	1387	281	636	0442	116	264	0439	165	372	0444	0533	163	198	0823	48	185	233	59	34	17	73	128	841
351	Marcus Morris	PF	30	LAC	19	19	549	74	174	0425	26	84	0310	48	90	0533	0500	18	22	0818	11	67	78	27	13	13	24	52	192
352	Markieff Morris	PF	30	TOT	58	17	1187	203	458	0443	88	228	0386	115	230	0500	0539	66	85	0776	40	178	218	77	31	17	76	133	560
352	Markieff Morris	PF	30	DET	44	16	988	175	389	0450	75	189	0397	100	200	0500	0546	61	79	0772	24	149	173	69	26	11	70	104	486
352	Markieff Morris	PF	30	LAL	14	1	199	28	69	0406	13	39	0333	15	30	0500	0500	5	6	0833	16	29	45	8	5	6	6	29	74
353	Monte Morris	PG	24	DEN	73	12	1636	260	566	0459	65	172	0378	195	394	0495	0517	75	89	0843	24	113	137	255	55	17	53	73	660
354	Johnathan Motley	PF	24	LAC	13	0	41	11	15	0733	1	1	10000	10	14	0714	0767	5	7	0714	3	7	10	8	3	0	5	6	28
355	Emmanuel Mudiay	PG	23	UTA	54	2	850	151	327	0462	30	87	0345	121	240	0504	0508	63	83	0759	18	108	126	116	24	10	76	72	395
356	Mychal Mulder	SF	25	GSW	7	3	204	26	67	0388	16	52	0308	10	15	0667	0507	9	12	0750	3	20	23	8	2	1	5	20	77
357	Dejounte Murray	PG	23	SAS	66	58	1687	294	637	0462	41	111	0369	253	526	0481	0494	91	114	0798	69	314	383	271	111	17	125	143	720
358	Jamal Murray	PG	22	DEN	59	59	1904	408	894	0456	112	324	0346	296	570	0519	0519	163	185	0881	45	191	236	284	67	17	127	102	1091
359	Džanan Musa	SF	20	BRK	40	0	487	64	172	0372	19	78	0244	45	94	0479	0427	45	60	0750	21	65	86	43	15	1	36	30	192
360	Mike Muscala	C	28	OKC	47	2	572	77	189	0407	54	143	0378	23	46	0500	0550	18	22	0818	16	92	108	40	9	12	17	58	226
361	Svi Mykhailiuk	SF	22	DET	56	27	1265	166	405	0410	115	285	0404	51	120	0425	0552	57	70	0814	17	87	104	106	41	4	61	87	504
362	Abdel Nader	SF	26	OKC	55	6	867	123	263	0468	48	128	0375	75	135	0556	0559	51	66	0773	14	86	100	38	23	20	43	78	345
363	Larry Nance Jr0	PF	27	CLE	56	10	1472	229	431	0531	56	159	0352	173	272	0636	0596	50	74	0676	106	303	409	123	56	22	60	91	564
364	Shabazz Napier	PG	28	TOT	56	32	1344	188	456	0412	76	240	0317	112	216	0519	0496	126	153	0824	26	132	158	262	69	11	128	101	578
364	Shabazz Napier	PG	28	MIN	36	22	856	114	283	0403	47	159	0296	67	124	0540	0486	72	88	0818	17	93	110	187	40	7	76	62	347
364	Shabazz Napier	PG	28	WAS	20	10	488	74	173	0428	29	81	0358	45	92	0489	0512	54	65	0831	9	39	48	75	29	4	52	39	231
365	Raul Neto	PG	27	PHI	54	3	668	101	222	0455	34	88	0386	67	134	0500	0532	39	47	0830	11	50	61	95	24	6	47	50	275
366	Malik Newman	SG	22	CLE	1	0	4	0	2	0000	0	1	0000	0	1	0000	0000	2	2	10000	0	0	0	0	0	0	1	0	2
367	Georges Niang	PF	26	UTA	66	1	923	141	322	0438	90	225	0400	51	97	0526	0578	20	24	0833	15	112	127	44	18	5	30	75	392
368	Joakim Noah	C	34	LAC	5	0	50	4	8	0500	0	0	0	4	8	0500	0500	6	8	0750	5	11	16	7	1	1	6	9	14
369	Nerlens Noel	C	25	OKC	61	7	1127	184	269	0684	1	3	0333	183	266	0688	0686	80	106	0755	91	209	300	57	59	91	66	166	449
370	Zach Norvell	SG	22	TOT	5	0	41	3	12	0250	3	8	0375	0	4	0000	0375	1	1	10000	0	6	6	3	2	0	3	4	10
370	Zach Norvell	SG	22	LAL	2	0	5	0	1	0000	0	0	0	0	1	0000	0000	0	0	0	0	1	1	0	0	0	0	0	0
370	Zach Norvell	SG	22	GSW	3	0	36	3	11	0273	3	8	0375	0	3	0000	0409	1	1	10000	0	5	5	3	2	0	3	4	10
371	Jaylen Nowell	SG	20	MIN	15	0	151	19	53	0358	3	26	0115	16	27	0593	0387	16	17	0941	3	10	13	19	3	1	3	11	57
372	Frank Ntilikina	PG	21	NYK	57	26	1187	131	333	0393	44	137	0321	87	196	0444	0459	51	59	0864	23	98	121	172	54	16	71	142	357
373	Kendrick Nunn	PG	24	MIA	67	67	1962	401	914	0439	137	391	0350	264	523	0505	0514	85	100	0850	21	159	180	220	56	15	114	152	1024
374	Jusuf Nurkić	C	25	POR	8	8	253	54	109	0495	2	10	0200	52	99	0525	0505	31	35	0886	23	59	82	32	11	16	19	39	141
375	David Nwaba	SF	27	BRK	20	0	268	37	71	0521	12	28	0429	25	43	0581	0606	18	27	0667	8	37	45	8	11	12	8	32	104
376	Royce O'Neale	SF	26	UTA	71	62	2049	158	365	0433	92	244	0377	66	121	0545	0559	42	55	0764	27	362	389	180	59	32	61	202	450
377	Kyle O'Quinn	C	29	PHI	29	2	313	42	85	0494	7	27	0259	35	58	0603	0535	11	20	0550	34	82	116	51	7	24	20	37	102
378	Semi Ojeleye	PF	25	BOS	69	6	1011	80	196	0408	48	127	0378	32	69	0464	0531	28	32	0875	26	119	145	37	21	5	19	80	236
379	Jahlil Okafor	C	24	NOP	30	9	467	101	162	0623	1	3	0333	100	159	0629	0627	40	62	0645	48	79	127	37	7	22	38	67	243
380	Elie Okobo	PG	22	PHO	55	3	719	72	181	0398	25	71	0352	47	110	0427	0467	50	71	0704	16	74	90	115	24	4	38	54	219
381	Josh Okogie	SG	21	MIN	62	28	1547	170	398	0427	41	154	0266	129	244	0529	0479	152	191	0796	87	181	268	99	68	26	87	139	533
382	KZ Okpala	PF	20	MIA	5	0	26	3	5	0600	0	1	0000	3	4	0750	0600	1	2	0500	1	4	5	1	2	1	1	2	7
383	Victor Oladipo	SG	27	IND	19	16	528	97	246	0394	33	104	0317	64	142	0451	0461	48	59	0814	9	66	75	56	17	4	47	36	275
384	Kelly Olynyk	C	28	MIA	67	9	1300	184	398	0462	95	234	0406	89	164	0543	0582	86	100	0860	44	261	305	116	45	23	71	173	549
385	Miye Oni	SF	22	UTA	10	1	109	12	32	0375	7	19	0368	5	13	0385	0484	4	5	0800	5	12	17	4	4	2	4	9	35
386	Cedi Osman	SF	24	CLE	65	65	1910	266	609	0437	123	321	0383	143	288	0497	0538	63	94	0670	39	192	231	154	54	16	91	160	718
387	Kelly Oubre Jr0	SF	24	PHO	56	55	1933	373	826	0452	108	307	0352	265	519	0511	0517	192	246	0780	67	294	361	85	71	40	83	192	1046
388	Tariq Owens	PF	24	PHO	3	0	15	1	5	0200	0	2	0000	1	3	0333	0200	2	2	10000	2	1	3	0	1	0	0	1	4
389	Jeremy Pargo	PG	33	GSW	3	0	44	11	22	0500	3	7	0429	8	15	0533	0568	0	1	0000	1	2	3	8	1	0	4	8	25
390	Jabari Parker	PF	24	TOT	38	23	917	219	429	0510	32	119	0269	187	310	0603	0548	61	81	0753	61	153	214	68	45	16	64	99	531
390	Jabari Parker	PF	24	ATL	32	23	837	198	393	0504	31	115	0270	167	278	0601	0543	53	72	0736	54	137	191	58	42	15	60	93	480
390	Jabari Parker	PF	24	SAC	6	0	80	21	36	0583	1	4	0250	20	32	0625	0597	8	9	0889	7	16	23	10	3	1	4	6	51
391	Chandler Parsons	PF	31	ATL	5	0	54	5	18	0278	4	14	0286	1	4	0250	0389	0	0	0	1	6	7	3	4	1	3	3	14
392	Eric Paschall	PF	23	GSW	60	26	1654	318	640	0497	37	129	0287	281	511	0550	0526	164	212	0774	82	193	275	127	32	13	94	125	837
393	Anžejs Pasečņiks	C	24	WAS	27	0	437	61	116	0526	0	3	0000	61	113	0540	0526	34	58	0586	42	65	107	18	9	12	24	75	156
394	Patrick Patterson	PF	30	LAC	59	18	776	95	233	0408	67	172	0390	28	61	0459	0552	35	43	0814	35	116	151	41	7	3	21	54	292
395	Justin Patton	C	22	OKC	5	0	24	4	10	0400	1	4	0250	3	6	0500	0450	0	0	0	1	4	5	2	0	0	2	4	9
396	Chris Paul	PG	34	OKC	70	70	2208	434	887	0489	111	304	0365	323	583	0554	0552	253	279	0907	26	323	349	472	111	11	161	158	1232
397	Cameron Payne	SG	25	PHO	8	0	183	33	68	0485	15	29	0517	18	39	0462	0596	6	7	0857	4	27	31	24	8	2	11	20	87
398	Elfrid Payton	PG	25	NYK	45	36	1246	193	440	0439	14	69	0203	179	371	0482	0455	49	86	0570	52	160	212	323	70	17	96	89	449
399	Gary Payton II	SF	27	WAS	29	17	432	48	116	0414	13	46	0283	35	70	0500	0470	4	8	0500	26	54	80	48	33	7	20	54	113
400	Norvel Pelle	C	26	PHI	24	0	232	25	48	0521	0	1	0000	25	47	0532	0521	7	14	0500	20	52	72	8	3	31	18	55	57
401	Theo Pinson	SG	24	BRK	33	0	365	45	155	0290	15	80	0188	30	75	0400	0339	15	16	0938	10	44	54	56	17	4	33	35	120
402	Mason Plumlee	C	29	DEN	61	1	1057	177	288	0615	0	5	0000	177	283	0625	0615	83	155	0535	98	219	317	154	33	38	82	143	437
403	Jakob Poeltl	C	24	SAS	66	18	1171	166	266	0624	0	0	0	166	266	0624	0624	40	86	0465	131	244	375	116	37	95	54	126	372
404	Vincent Poirier	C	26	BOS	22	0	130	17	36	0472	1	2	0500	16	34	0471	0486	6	7	0857	13	30	43	8	2	9	8	25	41
405	Shamorie Ponds	PG	21	TOR	4	0	11	3	5	0600	1	2	0500	2	3	0667	0700	2	2	10000	0	1	1	2	0	1	0	2	9
406	Jordan Poole	SG	20	GSW	57	14	1274	167	502	0333	74	265	0279	93	237	0392	0406	95	119	0798	9	109	118	134	35	10	74	94	503
407	Kevin Porter Jr0	SF	19	CLE	50	3	1162	186	421	0442	53	158	0335	133	263	0506	0505	73	101	0723	22	140	162	109	46	14	93	135	498
408	Michael Porter Jr0	SF	21	DEN	55	8	903	195	383	0509	62	147	0422	133	236	0564	0590	60	72	0833	66	193	259	46	27	25	49	100	512
409	Otto Porter Jr0	SF	26	CHI	14	9	331	62	140	0443	24	62	0387	38	78	0487	0529	19	27	0704	13	35	48	25	15	6	11	31	167
410	Bobby Portis	PF	24	NYK	66	5	1393	265	589	0450	67	187	0358	198	402	0493	0507	71	93	0763	80	258	338	98	32	18	73	110	668
411	Kristaps Porziņģis	C	24	DAL	57	57	1814	398	932	0427	142	403	0352	256	529	0484	0503	226	283	0799	100	440	540	102	41	115	92	185	1164
412	Dwight Powell	C	28	DAL	40	37	1061	146	229	0638	10	39	0256	136	190	0716	0659	74	111	0667	75	152	227	59	34	22	36	102	376
413	Norman Powell	SG	26	TOR	52	26	1479	296	598	0495	109	273	0399	187	325	0575	0586	129	153	0843	26	164	190	91	60	21	77	108	830
414	Taurean Prince	PF	25	BRK	64	61	1857	278	739	0376	146	431	0339	132	308	0429	0475	71	89	0798	50	331	381	116	57	25	127	159	773
415	Chasson Randle	PG	26	GSW	3	0	40	0	4	0000	0	2	0000	0	2	0000	0000	5	6	0833	0	2	2	5	2	0	0	3	5
416	Julius Randle	PF	25	NYK	64	64	2080	463	1006	0460	64	231	0277	399	775	0515	0492	258	352	0733	151	471	622	198	51	22	193	178	1248
417	Josh Reaves	SF	22	DAL	4	0	28	3	9	0333	0	2	0000	3	7	0429	0333	2	2	10000	1	2	3	3	0	0	0	5	8
418	Cam Reddish	SF	20	ATL	58	34	1551	213	554	0384	83	250	0332	130	304	0428	0459	101	126	0802	35	181	216	87	62	28	96	132	610
419	J0J0 Redick	SG	35	NOP	60	36	1581	286	631	0453	180	397	0453	106	234	0453	0596	165	185	0892	10	141	151	119	20	10	75	96	917
420	Naz Reid	C	20	MIN	30	11	495	100	243	0412	32	97	0330	68	146	0466	0477	37	53	0698	34	90	124	35	19	22	22	83	269
421	Josh Richardson	SG	26	PHI	55	53	1693	278	646	0430	85	249	0341	193	397	0486	0496	114	141	0809	41	133	174	162	52	36	104	136	755
422	Austin Rivers	SG	27	HOU	68	4	1594	211	501	0421	96	270	0356	115	231	0498	0517	78	111	0703	27	148	175	113	49	10	50	129	596
423	Andre Roberson	SF	28	OKC	7	0	87	8	29	0276	3	14	0214	5	15	0333	0328	1	2	0500	7	20	27	4	1	3	2	13	20
424	Duncan Robinson	SG	25	MIA	73	68	2166	323	687	0470	270	606	0446	53	81	0654	0667	67	72	0931	10	222	232	102	35	19	70	193	983
425	Glenn Robinson III	SF	26	TOT	62	52	1786	288	592	0486	77	197	0391	211	395	0534	0552	74	86	0860	81	189	270	96	54	16	55	100	727
425	Glenn Robinson III	SF	26	GSW	48	48	1516	244	507	0481	68	170	0400	176	337	0522	0548	63	74	0851	66	160	226	85	45	14	50	82	619
425	Glenn Robinson III	SF	26	PHI	14	4	270	44	85	0518	9	27	0333	35	58	0603	0571	11	12	0917	15	29	44	11	9	2	5	18	108
426	Jerome Robinson	SG	22	TOT	63	6	979	115	310	0371	49	153	0320	66	157	0420	0450	40	57	0702	13	116	129	87	28	17	49	112	319
426	Jerome Robinson	SG	22	LAC	42	1	476	46	136	0338	19	67	0284	27	69	0391	0408	11	19	0579	5	55	60	46	13	8	26	55	122
426	Jerome Robinson	SG	22	WAS	21	5	503	69	174	0397	30	86	0349	39	88	0443	0483	29	38	0763	8	61	69	41	15	9	23	57	197
427	Justin Robinson	PG	22	WAS	9	0	49	5	12	0417	3	5	0600	2	7	0286	0542	0	0	0	1	4	5	7	0	1	3	2	13
428	Mitchell Robinson	C	21	NYK	61	7	1412	253	341	0742	0	0	0	253	341	0742	0742	84	148	0568	186	242	428	36	52	119	37	194	590
429	Isaiah Roby	PF	21	OKC	3	0	11	0	1	0000	0	0	0	0	1	0000	0000	0	0	0	0	2	2	0	0	0	1	1	0
430	Rajon Rondo	PG	33	LAL	48	3	984	137	328	0418	41	125	0328	96	203	0473	0480	27	41	0659	23	119	142	240	40	2	91	58	342
431	Derrick Rose	PG	31	DET	50	15	1298	369	753	0490	45	147	0306	324	606	0535	0520	121	139	0871	27	94	121	278	40	16	126	49	904
432	Terrence Ross	SG	28	ORL	69	0	1889	341	846	0403	177	504	0351	164	342	0480	0508	157	184	0853	13	209	222	82	77	24	70	109	1016
433	Terry Rozier	PG	25	CHO	63	63	2164	398	941	0423	172	423	0407	226	518	0436	0514	166	190	0874	50	226	276	259	61	10	141	126	1134
434	Ricky Rubio	PG	29	PHO	65	65	2016	287	692	0415	78	216	0361	209	476	0439	0471	195	226	0863	46	258	304	570	94	11	173	167	847
435	D'Angelo Russell	PG	23	TOT	45	45	1452	360	846	0426	158	431	0367	202	415	0487	0519	161	199	0809	17	160	177	285	48	13	147	86	1039
435	D'Angelo Russell	PG	23	GSW	33	33	1060	273	635	0430	120	321	0374	153	314	0487	0524	113	144	0785	14	108	122	206	31	9	101	64	779
435	D'Angelo Russell	PG	23	MIN	12	12	392	87	211	0412	38	110	0345	49	101	0485	0502	48	55	0873	3	52	55	79	17	4	46	22	260
436	Domantas Sabonis	PF	23	IND	62	62	2159	458	848	0540	17	67	0254	441	781	0565	0550	214	296	0723	189	582	771	310	47	30	170	195	1147
437	Luka Šamanić	PF	20	SAS	3	1	48	5	16	0313	3	8	0375	2	8	0250	0406	3	4	0750	1	9	10	6	0	2	2	6	16
438	JaKarr Sampson	PF	26	IND	34	12	471	68	115	0591	2	13	0154	66	102	0647	0600	18	27	0667	20	68	88	21	16	12	15	64	156
439	Dario Šarić	PF	25	PHO	66	51	1632	256	538	0476	84	235	0357	172	303	0568	0554	108	128	0844	100	306	406	123	37	16	88	156	704
440	Tomáš Satoranský	SG	28	CHI	65	64	1878	237	551	0430	64	199	0322	173	352	0491	0488	106	121	0876	76	178	254	354	80	7	130	135	644
441	Admiral Schofield	PF	22	WAS	33	2	368	35	92	0380	19	61	0311	16	31	0516	0484	10	15	0667	7	40	47	15	8	4	7	50	99
442	Dennis Schröder	PG	26	OKC	65	2	1999	453	965	0469	125	325	0385	328	640	0513	0534	198	236	0839	19	217	236	262	45	14	166	146	1229
443	Mike Scott	PF	31	PHI	68	11	1207	149	350	0426	80	217	0369	69	133	0519	0540	30	37	0811	65	183	248	56	21	5	26	96	408
444	Thabo Sefolosha	PF	35	HOU	41	0	436	37	91	0407	15	54	0278	22	37	0595	0489	3	8	0375	21	72	93	25	24	12	15	43	92
445	Collin Sexton	PG	21	CLE	65	65	2143	513	1086	0472	97	255	0380	416	831	0501	0517	226	267	0846	61	143	204	192	65	7	158	142	1349
446	Landry Shamet	SG	22	LAC	53	30	1452	158	391	0404	111	296	0375	47	95	0495	0546	65	76	0855	6	94	100	99	20	10	42	142	492
447	Marial Shayok	SG	24	PHI	4	0	28	3	12	0250	2	6	0333	1	6	0167	0333	3	4	0750	1	6	7	1	0	1	3	4	11
448	Iman Shumpert	SF	29	BRK	13	0	241	21	64	0328	8	33	0242	13	31	0419	0391	4	7	0571	9	25	34	12	12	2	10	21	54
449	Pascal Siakam	PF	25	TOR	60	60	2110	500	1104	0453	131	365	0359	369	739	0499	0512	240	303	0792	64	375	439	207	61	53	148	170	1371
450	Chris Silva	PF	23	MIA	44	0	346	48	78	0615	0	3	0000	48	75	0640	0615	37	55	0673	60	66	126	23	9	21	32	85	133
451	Ben Simmons	PG	23	PHI	57	57	2017	375	647	0580	2	7	0286	373	640	0583	0581	185	298	0621	113	331	444	455	119	33	200	186	937
452	Anfernee Simons	SG	20	POR	70	4	1449	214	536	0399	75	226	0332	139	310	0448	0469	76	92	0826	25	127	152	97	26	10	61	135	579
453	Alen Smailagić	C	19	GSW	14	0	139	20	40	0500	3	13	0231	17	27	0630	0538	16	19	0842	10	17	27	13	3	4	11	14	59
454	Marcus Smart	SG	25	BOS	60	40	1919	256	682	0375	137	395	0347	119	287	0415	0476	127	152	0836	42	183	225	291	101	29	103	162	776
455	Dennis Smith Jr0	PG	22	NYK	34	3	537	72	211	0341	16	54	0296	56	157	0357	0379	27	53	0509	21	57	78	98	28	8	58	65	187
456	Ish Smith	PG	31	WAS	68	23	1787	308	689	0447	62	169	0367	246	520	0473	0492	62	86	0721	30	189	219	334	59	30	95	106	740
457	J0R0 Smith	SG	34	LAL	6	0	79	7	22	0318	1	11	0091	6	11	0545	0341	2	2	10000	0	5	5	3	1	0	4	5	17
458	Zhaire Smith	SF	20	PHI	7	0	32	3	11	0273	0	3	0000	3	8	0375	0273	2	4	0500	0	2	2	2	3	0	2	4	8
459	Tony Snell	SF	28	DET	59	57	1641	170	382	0445	102	254	0402	68	128	0531	0579	32	32	10000	9	102	111	127	32	15	31	101	474
460	Omari Spellman	C	22	GSW	49	3	886	127	295	0431	43	110	0391	84	185	0454	0503	73	92	0793	77	142	219	47	33	24	54	63	370
461	Max Strus	SF	23	CHI	2	0	6	2	3	0667	0	1	0000	2	2	10000	0667	1	1	10000	1	0	1	0	0	0	0	1	5
462	Edmond Sumner	SG	24	IND	31	3	447	61	142	0430	14	53	0264	47	89	0528	0479	16	29	0552	11	35	46	55	15	9	22	44	152
463	Caleb Swanigan	PF-C	22	TOT	27	1	288	28	47	0596	0	2	0000	28	45	0622	0596	9	17	0529	27	73	100	31	3	7	37	62	65
463	Caleb Swanigan	C	22	SAC	7	0	23	2	4	0500	0	0	0	2	4	0500	0500	1	2	0500	2	5	7	2	1	2	6	8	5
463	Caleb Swanigan	PF	22	POR	20	1	265	26	43	0605	0	2	0000	26	41	0634	0605	8	15	0533	25	68	93	29	2	5	31	54	60
464	Jayson Tatum	PF	21	BOS	66	66	2265	552	1226	0450	189	469	0403	363	757	0480	0527	254	313	0812	64	396	460	200	93	57	155	136	1547
465	Jeff Teague	PG	31	TOT	59	17	1464	213	489	0436	43	117	0368	170	372	0457	0480	172	197	0873	27	115	142	308	44	19	116	106	641
465	Jeff Teague	PG	31	MIN	34	13	945	145	324	0448	33	87	0379	112	237	0473	0498	125	144	0868	15	73	88	208	25	13	76	70	448
465	Jeff Teague	PG	31	ATL	25	4	519	68	165	0412	10	30	0333	58	135	0430	0442	47	53	0887	12	42	54	100	19	6	40	36	193
466	Garrett Temple	SG	33	BRK	62	35	1730	222	587	0378	127	386	0329	95	201	0473	0486	70	87	0805	29	189	218	156	49	29	62	108	641
467	Daniel Theis	C	27	BOS	65	64	1566	241	426	0566	32	96	0333	209	330	0633	0603	87	114	0763	140	286	426	111	37	84	54	219	601
468	Isaiah Thomas	PG	30	WAS	40	37	925	174	426	0408	78	189	0413	96	237	0405	0500	62	76	0816	11	57	68	146	13	6	77	77	488
469	Khyri Thomas	SG	23	DET	8	0	61	5	17	0294	5	14	0357	0	3	0000	0441	2	4	0500	1	0	1	3	3	0	3	9	17
470	Lance Thomas	PF	31	BRK	7	4	98	8	23	0348	4	13	0308	4	10	0400	0435	4	4	10000	2	11	13	6	0	0	6	11	24
471	Matt Thomas	SG	25	TOR	41	1	440	73	150	0487	47	99	0475	26	51	0510	0643	9	12	0750	9	52	61	22	10	1	16	38	202
472	Tristan Thompson	PF	28	CLE	57	51	1721	288	562	0512	9	23	0391	279	539	0518	0520	99	161	0615	226	351	577	120	33	50	103	124	684
473	Sindarius Thornwell	SF	25	NOP	2	0	35	6	11	0545	2	4	0500	4	7	0571	0636	2	4	0500	0	4	4	4	1	1	2	2	16
474	Matisse Thybulle	SG	22	PHI	65	14	1287	112	265	0423	56	157	0357	56	108	0519	0528	25	41	0610	44	63	107	79	94	47	51	141	305
475	Anthony Tolliver	PF	34	TOT	55	13	872	65	182	0357	49	145	0338	16	37	0432	0492	21	29	0724	34	120	154	42	19	11	34	74	200
475	Anthony Tolliver	PF	34	POR	33	9	554	43	117	0368	30	89	0337	13	28	0464	0496	13	19	0684	27	83	110	29	8	9	21	54	129
475	Anthony Tolliver	PF	34	SAC	9	0	82	3	17	0176	2	15	0133	1	2	0500	0235	1	2	0500	2	9	11	3	4	1	4	6	9
475	Anthony Tolliver	PF	34	MEM	13	4	236	19	48	0396	17	41	0415	2	7	0286	0573	7	8	0875	5	28	33	10	7	1	9	14	62
476	Juan Toscano-Anderson	SG	26	GSW	13	6	272	29	63	0460	8	23	0348	21	40	0525	0524	3	5	0600	9	43	52	26	13	5	16	30	69
477	Karl-Anthony Towns	C	24	MIN	35	35	1187	316	622	0508	114	277	0412	202	345	0586	0600	180	226	0796	95	283	378	153	33	42	110	117	926
478	Gary Trent Jr0	SF	21	POR	61	8	1332	196	441	0444	112	268	0418	84	173	0486	0571	37	45	0822	25	75	100	61	48	16	21	90	541
479	Allonzo Trier	SG	24	NYK	24	1	291	51	106	0481	19	53	0358	32	53	0604	0571	34	43	0791	6	23	29	28	3	4	22	29	155
480	P0J0 Tucker	PF	34	HOU	72	72	2467	177	426	0415	107	299	0358	70	127	0551	0541	39	48	0813	112	364	476	115	77	36	72	229	500
481	Rayjon Tucker	SG	22	UTA	20	0	161	20	43	0465	3	17	0176	17	26	0654	0500	19	23	0826	3	17	20	5	1	1	8	10	62
482	Evan Turner	SG	31	ATL	19	0	251	25	67	0373	0	5	0000	25	62	0403	0373	12	14	0857	8	30	38	38	9	8	26	20	62
483	Myles Turner	C	23	IND	62	62	1826	268	587	0457	86	250	0344	182	337	0540	0530	127	169	0751	86	321	407	72	46	132	85	166	749
484	Jarrod Uthoff	PF	26	TOT	7	0	53	7	18	0389	3	9	0333	4	9	0444	0472	2	2	10000	2	4	6	0	1	0	0	2	19
484	Jarrod Uthoff	PF	26	MEM	4	0	14	1	7	0143	0	4	0000	1	3	0333	0143	2	2	10000	1	0	1	0	1	0	0	1	4
484	Jarrod Uthoff	PF	26	WAS	3	0	39	6	11	0545	3	5	0600	3	6	0500	0682	0	0	0	1	4	5	0	0	0	0	1	15
485	Jonas Valančiūnas	C	27	MEM	70	70	1845	432	739	0585	32	91	0352	400	648	0617	0606	148	200	0740	213	575	788	131	30	76	127	185	1044
486	Denzel Valentine	SF	26	CHI	36	5	488	97	237	0409	46	137	0336	51	100	0510	0506	6	8	0750	9	65	74	43	26	6	26	51	246
487	Jarred Vanderbilt	PF	20	TOT	11	0	46	5	8	0625	0	1	0000	5	7	0714	0625	2	2	10000	3	6	9	2	3	1	7	6	12
487	Jarred Vanderbilt	PF	20	DEN	9	0	41	5	7	0714	0	0	0	5	7	0714	0714	0	0	0	3	5	8	2	3	1	7	6	10
487	Jarred Vanderbilt	PF	20	MIN	2	0	5	0	1	0000	0	1	0000	0	0	0	0000	2	2	10000	0	1	1	0	0	0	0	0	2
488	Fred VanVleet	SG	25	TOR	54	54	1928	319	773	0413	146	374	0390	173	399	0434	0507	168	198	0848	18	185	203	357	100	17	121	132	952
489	Gabe Vincent	PG	23	MIA	9	0	83	8	37	0216	6	27	0222	2	10	0200	0297	0	0	0	0	5	5	6	5	0	1	6	22
490	Noah Vonleh	C	24	TOT	36	1	377	52	92	0565	3	15	0200	49	77	0636	0582	25	32	0781	37	87	124	28	11	6	21	40	132
490	Noah Vonleh	C	24	MIN	29	1	347	47	86	0547	2	14	0143	45	72	0625	0558	23	28	0821	34	82	116	26	11	6	19	36	119
490	Noah Vonleh	C	24	DEN	7	0	30	5	6	0833	1	1	10000	4	5	0800	0917	2	4	0500	3	5	8	2	0	0	2	4	13
491	Nikola Vučević	C	29	ORL	62	62	1998	493	1033	0477	98	289	0339	395	744	0531	0525	131	167	0784	140	533	673	222	54	47	88	135	1215
492	Dean Wade	PF	23	CLE	12	0	71	9	13	0692	2	4	0500	7	9	0778	0769	0	1	0000	3	16	19	2	2	4	3	8	20
493	Moritz Wagner	C	22	WAS	45	5	835	145	266	0545	25	80	0313	120	186	0645	0592	78	95	0821	56	163	219	56	28	19	66	152	393
494	Dion Waiters	SG	28	TOT	10	0	207	41	99	0414	15	47	0319	26	52	0500	0490	14	17	0824	2	22	24	20	4	6	16	21	111
494	Dion Waiters	SG	28	MIA	3	0	42	10	26	0385	8	17	0471	2	9	0222	0538	0	1	0000	0	11	11	3	0	2	3	5	28
494	Dion Waiters	SG	28	LAL	7	0	165	31	73	0425	7	30	0233	24	43	0558	0473	14	16	0875	2	11	13	17	4	4	13	16	83
495	Kemba Walker	PG	29	BOS	56	56	1742	378	889	0425	180	473	0381	198	416	0476	0526	209	242	0864	36	181	217	268	48	28	117	91	1145
496	Lonnie Walker IV	SG	21	SAS	61	12	988	152	357	0426	41	101	0406	111	256	0434	0483	44	61	0721	23	116	139	68	32	14	44	78	389
497	Tyrone Wallace	SG	25	ATL	14	0	160	14	44	0318	1	15	0067	13	29	0448	0330	11	17	0647	3	19	22	13	7	1	10	19	40
498	Derrick Walton	PG	24	TOT	26	1	248	18	39	0462	10	24	0417	8	15	0533	0590	7	9	0778	2	14	16	27	7	0	5	21	53
498	Derrick Walton	PG	24	LAC	23	1	222	17	36	0472	9	21	0429	8	15	0533	0597	7	9	0778	2	13	15	22	4	0	4	19	50
498	Derrick Walton	PG	24	DET	3	0	26	1	3	0333	1	3	0333	0	0	0	0500	0	0	0	0	1	1	5	3	0	1	2	3
499	Brad Wanamaker	PG	30	BOS	71	1	1369	162	362	0448	37	102	0363	125	260	0481	0499	126	136	0926	22	122	144	179	61	14	76	133	487
500	T0J0 Warren	SF	26	IND	67	67	2202	534	997	0536	91	226	0403	443	771	0575	0581	167	204	0819	68	212	280	99	78	34	84	187	1326
501	P0J0 Washington	PF	21	CHO	58	57	1759	268	589	0455	86	230	0374	182	359	0507	0528	88	136	0647	58	258	316	123	51	44	93	158	710
502	Yuta Watanabe	SF	25	MEM	18	0	105	15	34	0441	3	8	0375	12	26	0462	0485	3	8	0375	7	13	20	5	5	1	2	9	36
503	Tremont Waters	PG	22	BOS	11	1	119	14	49	0286	4	24	0167	10	25	0400	0327	8	8	10000	0	12	12	16	10	2	15	13	40
504	Paul Watson	SF	25	TOT	10	0	87	10	26	0385	4	12	0333	6	14	0429	0462	7	9	0778	2	15	17	8	4	1	3	5	31
504	Paul Watson	SF	25	ATL	2	0	17	0	7	0000	0	3	0000	0	4	0000	0000	0	0	0	0	2	2	3	1	0	0	1	0
504	Paul Watson	SF	25	TOR	8	0	70	10	19	0526	4	9	0444	6	10	0600	0632	7	9	0778	2	13	15	5	3	1	3	4	31
505	Quinndary Weatherspoon	SG	23	SAS	11	0	78	5	17	0294	1	5	0200	4	12	0333	0324	1	2	0500	1	6	7	11	3	1	5	8	12
506	Russell Westbrook	PG	31	HOU	57	57	2049	604	1281	0472	55	213	0258	549	1068	0514	0493	290	380	0763	100	351	451	401	93	20	255	200	1553
507	Coby White	PG	19	CHI	65	1	1674	312	792	0394	133	376	0354	179	416	0430	0478	102	129	0791	28	202	230	175	49	6	109	117	859
508	Derrick White	SG	25	SAS	68	20	1677	253	552	0458	79	216	0366	174	336	0518	0530	180	211	0853	35	188	223	241	44	59	89	152	765
509	Hassan Whiteside	C	30	POR	67	61	2008	436	702	0621	4	7	0571	432	695	0622	0624	164	239	0686	258	647	905	78	26	196	120	196	1040
510	Andrew Wiggins	SF	24	TOT	54	54	1858	437	978	0447	111	334	0332	326	644	0506	0504	190	268	0709	66	208	274	198	45	53	132	127	1175
510	Andrew Wiggins	SF	24	MIN	42	42	1455	351	790	0444	91	275	0331	260	515	0505	0502	149	207	0720	48	171	219	155	29	36	107	101	942
510	Andrew Wiggins	SF	24	GSW	12	12	403	86	188	0457	20	59	0339	66	129	0512	0511	41	61	0672	18	37	55	43	16	17	25	26	233
511	Grant Williams	PF	21	BOS	69	5	1043	87	211	0412	24	96	0250	63	115	0548	0469	39	54	0722	59	119	178	68	30	36	50	163	237
512	Johnathan Williams	PF	24	WAS	15	6	180	19	34	0559	0	2	0000	19	32	0594	0559	7	13	0538	24	40	64	8	1	8	5	16	45
513	Kenrich Williams	PF	25	NOP	39	18	832	51	147	0347	25	97	0258	26	50	0520	0432	9	26	0346	51	135	186	57	27	21	22	88	136
514	Lou Williams	PG	33	LAC	65	8	1864	391	936	0418	111	315	0352	280	621	0451	0477	292	339	0861	31	170	201	365	43	12	182	80	1185
515	Marvin Williams	PF	33	TOT	58	1	1129	119	267	0446	56	156	0359	63	111	0568	0551	49	57	0860	30	153	183	60	36	30	33	103	343
515	Marvin Williams	PF	33	CHO	41	1	808	94	210	0448	44	117	0376	50	93	0538	0552	43	50	0860	15	94	109	41	26	22	25	71	275
515	Marvin Williams	PF	33	MIL	17	0	321	25	57	0439	12	39	0308	13	18	0722	0544	6	7	0857	15	59	74	19	10	8	8	32	68
516	Robert Williams	C	22	BOS	29	1	388	64	88	0727	0	0	0	64	88	0727	0727	22	34	0647	40	88	128	27	22	35	21	51	150
517	Nigel Williams-Goss	PG	25	UTA	10	0	50	5	16	0313	2	7	0286	3	9	0333	0375	2	2	10000	2	4	6	6	3	1	3	6	14
518	Zion Williamson	PF	19	NOP	24	24	668	210	360	0583	6	14	0429	204	346	0590	0592	114	178	0640	64	86	150	50	16	9	59	42	540
519	D0J0 Wilson	PF	23	MIL	37	1	363	52	132	0394	18	73	0247	34	59	0576	0462	11	18	0611	12	80	92	25	3	5	19	33	133
520	Justise Winslow	SG	23	MIA	11	5	352	50	129	0388	6	27	0222	44	102	0431	0411	18	27	0667	16	57	73	44	7	5	24	38	124
521	Christian Wood	PF	24	DET	62	12	1325	288	508	0567	54	140	0386	234	368	0636	0620	180	242	0744	104	286	390	60	34	54	84	98	810
522	Delon Wright	PG	27	DAL	73	5	1570	190	411	0462	47	127	0370	143	284	0504	0519	77	100	0770	70	210	280	244	85	22	73	93	504
523	Justin Wright-Foreman	PG	22	UTA	4	0	45	7	20	0350	2	10	0200	5	10	0500	0400	3	4	0750	0	5	5	7	2	0	3	5	19
524	Thaddeus Young	PF	31	CHI	64	16	1591	269	601	0448	79	222	0356	190	379	0501	0513	42	72	0583	94	221	315	117	92	23	102	134	659
525	Trae Young	PG	21	ATL	60	60	2120	546	1249	0437	205	568	0361	341	681	0501	0519	481	559	0860	32	223	255	560	65	8	289	104	1778
526	Cody Zeller	C	27	CHO	58	39	1341	251	479	0524	18	75	0240	233	404	0577	0543	122	179	0682	160	251	411	88	40	25	75	140	642
527	Tyler Zeller	C	30	SAS	2	0	4	1	4	0250	0	0	0	1	4	0250	0250	0	0	0	3	1	4	0	0	0	0	0	2
528	Ante Žižić	C	23	CLE	22	0	221	41	72	0569	0	0	0	41	72	0569	0569	14	19	0737	18	48	66	6	7	5	10	27	96
529	Ivica Zubac	C	22	LAC	72	70	1326	236	385	0613	0	2	0000	236	383	0616	0613	124	166	0747	197	346	543	82	16	66	61	168	596
